STUSPS,total_acres_2021,year,morill_acres,homestead_acres,morill_acres_cum,homestead_acres_cum
AL,33496065.26225885,1862,0,0,0,0
AL,33496065.26225885,1863,0,0,0,0
AL,33496065.26225885,1864,0,0,0,0
AL,33496065.26225885,1865,0,0,0,0
AL,33496065.26225885,1866,0,0,0,0
AL,33496065.26225885,1867,0,0,0,0
AL,33496065.26225885,1868,0,0,0,0
AL,33496065.26225885,1869,0,0,0,0
AL,33496065.26225885,1870,0,0,0,0
AL,33496065.26225885,1871,0,0,0,0
AL,33496065.26225885,1872,0,1565,0,1565
AL,33496065.26225885,1873,0,4594,0,6159
AL,33496065.26225885,1874,0,13178,0,19337
AL,33496065.26225885,1875,0,43735,0,63072
AL,33496065.26225885,1876,0,99292,0,162364
AL,33496065.26225885,1877,0,59541,0,221905
AL,33496065.26225885,1878,0,60078,0,281983
AL,33496065.26225885,1879,0,55609,0,337592
AL,33496065.26225885,1880,0,43834,0,381426
AL,33496065.26225885,1881,0,63826,0,445252
AL,33496065.26225885,1882,0,96896,0,542148
AL,33496065.26225885,1883,0,118625,0,660773
AL,33496065.26225885,1884,0,131955,0,792728
AL,33496065.26225885,1885,0,159517,0,952245
AL,33496065.26225885,1886,0,180982,0,1133227
AL,33496065.26225885,1887,0,176825,0,1310052
AL,33496065.26225885,1888,0,191477,0,1501529
AL,33496065.26225885,1889,0,186271,0,1687800
AL,33496065.26225885,1890,0,205648,0,1893448
AL,33496065.26225885,1891,0,202176,0,2095624
AL,33496065.26225885,1892,0,159978,0,2255602
AL,33496065.26225885,1893,0,207771,0,2463373
AL,33496065.26225885,1894,0,236428,0,2699801
AL,33496065.26225885,1895,0,158210,0,2858011
AL,33496065.26225885,1896,0,170939,0,3028950
AL,33496065.26225885,1897,0,156588,0,3185538
AL,33496065.26225885,1898,0,124850,0,3310388
AL,33496065.26225885,1899,0,129033,0,3439421
AL,33496065.26225885,1900,0,109499,0,3548920
AL,33496065.26225885,1901,0,99632,0,3648552
AL,33496065.26225885,1902,0,71584,0,3720136
AL,33496065.26225885,1903,0,85583,0,3805719
AL,33496065.26225885,1904,0,76471,0,3882190
AL,33496065.26225885,1905,0,76979,0,3959169
AL,33496065.26225885,1906,0,72582,0,4031751
AL,33496065.26225885,1907,0,50338,0,4082089
AL,33496065.26225885,1908,0,45193,0,4127282
AL,33496065.26225885,1909,0,46515,0,4173797
AL,33496065.26225885,1910,0,43541,0,4217338
AL,33496065.26225885,1911,0,47476,0,4264814
AL,33496065.26225885,1912,0,34786,0,4299600
AL,33496065.26225885,1913,0,69423,0,4369023
AL,33496065.26225885,1914,0,31559,0,4400582
AL,33496065.26225885,1915,0,25426,0,4426008
AL,33496065.26225885,1916,0,48942,0,4474950
AL,33496065.26225885,1917,0,27357,0,4502307
AL,33496065.26225885,1918,0,14623,0,4516930
AL,33496065.26225885,1919,0,13804,0,4530734
AL,33496065.26225885,1920,0,10624,0,4541358
AL,33496065.26225885,1921,0,6939,0,4548297
AL,33496065.26225885,1922,0,5291,0,4553588
AL,33496065.26225885,1923,0,7792,0,4561380
AL,33496065.26225885,1924,0,4011,0,4565391
AL,33496065.26225885,1925,0,3126,0,4568517
AL,33496065.26225885,1926,0,3432,0,4571949
AL,33496065.26225885,1927,0,3465,0,4575414
AL,33496065.26225885,1928,0,0,0,4575414
AL,33496065.26225885,1929,0,0,0,4575414
AL,33496065.26225885,1930,0,0,0,4575414
AR,34238698.57790586,1862,0,0,0,0
AR,34238698.57790586,1863,0,0,0,0
AR,34238698.57790586,1864,0,0,0,0
AR,34238698.57790586,1865,0,0,0,0
AR,34238698.57790586,1866,0,0,0,0
AR,34238698.57790586,1867,0,0,0,0
AR,34238698.57790586,1868,0,0,0,0
AR,34238698.57790586,1869,0,0,0,0
AR,34238698.57790586,1870,0,0,0,0
AR,34238698.57790586,1871,0,825,0,825
AR,34238698.57790586,1872,0,3947,0,4772
AR,34238698.57790586,1873,0,14747,0,19519
AR,34238698.57790586,1874,0,68655,0,88174
AR,34238698.57790586,1875,0,122299,0,210473
AR,34238698.57790586,1876,0,188618,0,399091
AR,34238698.57790586,1877,0,177854,0,576945
AR,34238698.57790586,1878,0,185030,0,761975
AR,34238698.57790586,1879,0,103675,0,865650
AR,34238698.57790586,1880,0,110195,0,975845
AR,34238698.57790586,1881,0,89535,0,1065380
AR,34238698.57790586,1882,160,77244,160,1142624
AR,34238698.57790586,1883,0,117024,160,1259648
AR,34238698.57790586,1884,0,135067,160,1394715
AR,34238698.57790586,1885,0,143731,160,1538446
AR,34238698.57790586,1886,164.59,172264,324.59000000000003,1710710
AR,34238698.57790586,1887,0,225624,324.59000000000003,1936334
AR,34238698.57790586,1888,0,212350,324.59000000000003,2148684
AR,34238698.57790586,1889,0,181848,324.59000000000003,2330532
AR,34238698.57790586,1890,0,190121,324.59000000000003,2520653
AR,34238698.57790586,1891,0,168132,324.59000000000003,2688785
AR,34238698.57790586,1892,0,152430,324.59000000000003,2841215
AR,34238698.57790586,1893,0,181432,324.59000000000003,3022647
AR,34238698.57790586,1894,0,189553,324.59000000000003,3212200
AR,34238698.57790586,1895,0,179689,324.59000000000003,3391889
AR,34238698.57790586,1896,0,177563,324.59000000000003,3569452
AR,34238698.57790586,1897,0,176215,324.59000000000003,3745667
AR,34238698.57790586,1898,0,169476,324.59000000000003,3915143
AR,34238698.57790586,1899,0,183957,324.59000000000003,4099100
AR,34238698.57790586,1900,1608.12,249224,1932.71,4348324
AR,34238698.57790586,1901,0,223847,1932.71,4572171
AR,34238698.57790586,1902,640,204274,2572.71,4776445
AR,34238698.57790586,1903,0,215107,2572.71,4991552
AR,34238698.57790586,1904,160,186747,2732.71,5178299
AR,34238698.57790586,1905,0,210746,2732.71,5389045
AR,34238698.57790586,1906,0,250767,2732.71,5639812
AR,34238698.57790586,1907,0,218808,2732.71,5858620
AR,34238698.57790586,1908,0,226264,2732.71,6084884
AR,34238698.57790586,1909,0,185213,2732.71,6270097
AR,34238698.57790586,1910,0,206385,2732.71,6476482
AR,34238698.57790586,1911,0,177646,2732.71,6654128
AR,34238698.57790586,1912,0,191144,2732.71,6845272
AR,34238698.57790586,1913,0,159925,2732.71,7005197
AR,34238698.57790586,1914,0,156617,2732.71,7161814
AR,34238698.57790586,1915,0,112229,2732.71,7274043
AR,34238698.57790586,1916,0,88605,2732.71,7362648
AR,34238698.57790586,1917,0,130040,2732.71,7492688
AR,34238698.57790586,1918,0,93992,2732.71,7586680
AR,34238698.57790586,1919,0,99256,2732.71,7685936
AR,34238698.57790586,1920,0,97993,2732.71,7783929
AR,34238698.57790586,1921,0,71520,2732.71,7855449
AR,34238698.57790586,1922,0,53106,2732.71,7908555
AR,34238698.57790586,1923,0,42608,2732.71,7951163
AR,34238698.57790586,1924,0,42063,2732.71,7993226
AR,34238698.57790586,1925,0,28552,2732.71,8021778
AR,34238698.57790586,1926,0,18955,2732.71,8040733
AR,34238698.57790586,1927,0,19299,2732.71,8060032
AR,34238698.57790586,1928,0,13428,2732.71,8073460
AR,34238698.57790586,1929,0,15096,2732.71,8088556
AR,34238698.57790586,1930,0,16084,2732.71,8104640
AZ,73517528.31448689,1862,0,0,0,0
AZ,73517528.31448689,1863,0,0,0,0
AZ,73517528.31448689,1864,0,0,0,0
AZ,73517528.31448689,1865,0,0,0,0
AZ,73517528.31448689,1866,0,0,0,0
AZ,73517528.31448689,1867,0,0,0,0
AZ,73517528.31448689,1868,0,0,0,0
AZ,73517528.31448689,1869,0,0,0,0
AZ,73517528.31448689,1870,0,0,0,0
AZ,73517528.31448689,1871,0,0,0,0
AZ,73517528.31448689,1872,0,0,0,0
AZ,73517528.31448689,1873,0,0,0,0
AZ,73517528.31448689,1874,0,0,0,0
AZ,73517528.31448689,1875,800,0,800,0
AZ,73517528.31448689,1876,0,0,800,0
AZ,73517528.31448689,1877,0,800,800,800
AZ,73517528.31448689,1878,0,800,800,1600
AZ,73517528.31448689,1879,0,958,800,2558
AZ,73517528.31448689,1880,0,1890,800,4448
AZ,73517528.31448689,1881,0,2080,800,6528
AZ,73517528.31448689,1882,0,5315,800,11843
AZ,73517528.31448689,1883,0,6178,800,18021
AZ,73517528.31448689,1884,0,4535,800,22556
AZ,73517528.31448689,1885,0,4099,800,26655
AZ,73517528.31448689,1886,0,8392,800,35047
AZ,73517528.31448689,1887,0,7059,800,42106
AZ,73517528.31448689,1888,0,5913,800,48019
AZ,73517528.31448689,1889,0,8792,800,56811
AZ,73517528.31448689,1890,0,18067,800,74878
AZ,73517528.31448689,1891,0,18737,800,93615
AZ,73517528.31448689,1892,0,19182,800,112797
AZ,73517528.31448689,1893,0,20172,800,132969
AZ,73517528.31448689,1894,160,13444,960,146413
AZ,73517528.31448689,1895,0,10749,960,157162
AZ,73517528.31448689,1896,0,12922,960,170084
AZ,73517528.31448689,1897,0,13408,960,183492
AZ,73517528.31448689,1898,0,16042,960,199534
AZ,73517528.31448689,1899,0,15185,960,214719
AZ,73517528.31448689,1900,0,16820,960,231539
AZ,73517528.31448689,1901,0,18503,960,250042
AZ,73517528.31448689,1902,0,16943,960,266985
AZ,73517528.31448689,1903,0,24203,960,291188
AZ,73517528.31448689,1904,0,18092,960,309280
AZ,73517528.31448689,1905,0,19887,960,329167
AZ,73517528.31448689,1906,0,12737,960,341904
AZ,73517528.31448689,1907,0,14892,960,356796
AZ,73517528.31448689,1908,0,28483,960,385279
AZ,73517528.31448689,1909,0,27298,960,412577
AZ,73517528.31448689,1910,5074.24,35371,6034.24,447948
AZ,73517528.31448689,1911,716.73,54098,6750.969999999999,502046
AZ,73517528.31448689,1912,640,47038,7390.969999999999,549084
AZ,73517528.31448689,1913,0,94370,7390.969999999999,643454
AZ,73517528.31448689,1914,6168.38,120838,13559.349999999999,764292
AZ,73517528.31448689,1915,27859.54,118539,41418.89,882831
AZ,73517528.31448689,1916,40,171550,41458.89,1054381
AZ,73517528.31448689,1917,31070.45999999,151844,72529.34999999,1206225
AZ,73517528.31448689,1918,34041.08,142995,106570.42999999,1349220
AZ,73517528.31448689,1919,11858.09,127904,118428.51999998999,1477124
AZ,73517528.31448689,1920,800,153065,119228.51999998999,1630189
AZ,73517528.31448689,1921,7476.350000019996,177944,126704.87000000999,1808133
AZ,73517528.31448689,1922,0,141934,126704.87000000999,1950067
AZ,73517528.31448689,1923,13809.91999997,145531,140514.78999997998,2095598
AZ,73517528.31448689,1924,80,144333,140594.78999997998,2239931
AZ,73517528.31448689,1925,1280,144253,141874.78999997998,2384184
AZ,73517528.31448689,1926,0,118162,141874.78999997998,2502346
AZ,73517528.31448689,1927,0,120311,141874.78999997998,2622657
AZ,73517528.31448689,1928,0,63122,141874.78999997998,2685779
AZ,73517528.31448689,1929,0,106280,141874.78999997998,2792059
AZ,73517528.31448689,1930,0,95757,141874.78999997998,2887816
CA,101593708.35834907,1862,0,0,0,0
CA,101593708.35834907,1863,0,0,0,0
CA,101593708.35834907,1864,0,0,0,0
CA,101593708.35834907,1865,0,0,0,0
CA,101593708.35834907,1866,0,0,0,0
CA,101593708.35834907,1867,0,0,0,0
CA,101593708.35834907,1868,90674.16000000003,12286,90674.16000000003,12286
CA,101593708.35834907,1869,588039.7200000003,38570,678713.8800000004,50856
CA,101593708.35834907,1870,88023.41000000002,26232,766737.2900000004,77088
CA,101593708.35834907,1871,18385.87333332,30512,785123.1633333204,107600
CA,101593708.35834907,1872,271448.23499989964,21400,1056571.39833322,129000
CA,101593708.35834907,1873,172125.3345588,39514,1228696.7328920201,168514
CA,101593708.35834907,1874,365103.20472017996,27264,1593799.9376122002,195778
CA,101593708.35834907,1875,53513.743333370025,63282,1647313.68094557,259060
CA,101593708.35834907,1876,26601.221666699996,206580,1673914.90261227,465640
CA,101593708.35834907,1877,24743.28682982001,80277,1698658.18944209,545917
CA,101593708.35834907,1878,25568.26129983,120398,1724226.45074192,666315
CA,101593708.35834907,1879,2471.0433333299993,110423,1726697.4940752499,776738
CA,101593708.35834907,1880,6246.233333330001,111065,1732943.7274085798,887803
CA,101593708.35834907,1881,3993.27,162186,1736936.9974085798,1049989
CA,101593708.35834907,1882,4263.879999999999,185224,1741200.8774085797,1235213
CA,101593708.35834907,1883,10074.353260900003,170546,1751275.2306694796,1405759
CA,101593708.35834907,1884,1798.3478260999998,159578,1753073.5784955795,1565337
CA,101593708.35834907,1885,320.21276594999995,141335,1753393.7912615295,1706672
CA,101593708.35834907,1886,2263.1330850900003,126966,1755656.9243466195,1833638
CA,101593708.35834907,1887,0,124807,1755656.9243466195,1958445
CA,101593708.35834907,1888,4283.939999999998,142878,1759940.8643466195,2101323
CA,101593708.35834907,1889,777.06,154748,1760717.9243466195,2256071
CA,101593708.35834907,1890,1852.2700000000004,166405,1762570.1943466195,2422476
CA,101593708.35834907,1891,200,221257,1762770.1943466195,2643733
CA,101593708.35834907,1892,0,231526,1762770.1943466195,2875259
CA,101593708.35834907,1893,0,235643,1762770.1943466195,3110902
CA,101593708.35834907,1894,160,210279,1762930.1943466195,3321181
CA,101593708.35834907,1895,499.9700000000001,171494,1763430.1643466195,3492675
CA,101593708.35834907,1896,0,176595,1763430.1643466195,3669270
CA,101593708.35834907,1897,0,177663,1763430.1643466195,3846933
CA,101593708.35834907,1898,0,225694,1763430.1643466195,4072627
CA,101593708.35834907,1899,40,175382,1763470.1643466195,4248009
CA,101593708.35834907,1900,0,185598,1763470.1643466195,4433607
CA,101593708.35834907,1901,0,150369,1763470.1643466195,4583976
CA,101593708.35834907,1902,521.28,136006,1763991.4443466195,4719982
CA,101593708.35834907,1903,160,121952,1764151.4443466195,4841934
CA,101593708.35834907,1904,200,112639,1764351.4443466195,4954573
CA,101593708.35834907,1905,40,112609,1764391.4443466195,5067182
CA,101593708.35834907,1906,120,87873,1764511.4443466195,5155055
CA,101593708.35834907,1907,0,66579,1764511.4443466195,5221634
CA,101593708.35834907,1908,50.89,89571,1764562.3343466194,5311205
CA,101593708.35834907,1909,0,63226,1764562.3343466194,5374431
CA,101593708.35834907,1910,0,110765,1764562.3343466194,5485196
CA,101593708.35834907,1911,0,104263,1764562.3343466194,5589459
CA,101593708.35834907,1912,0,92224,1764562.3343466194,5681683
CA,101593708.35834907,1913,0,133565,1764562.3343466194,5815248
CA,101593708.35834907,1914,0,144127,1764562.3343466194,5959375
CA,101593708.35834907,1915,0,145469,1764562.3343466194,6104844
CA,101593708.35834907,1916,40,173416,1764602.3343466194,6278260
CA,101593708.35834907,1917,0,226931,1764602.3343466194,6505191
CA,101593708.35834907,1918,0,247702,1764602.3343466194,6752893
CA,101593708.35834907,1919,0,231031,1764602.3343466194,6983924
CA,101593708.35834907,1920,0,299836,1764602.3343466194,7283760
CA,101593708.35834907,1921,0,268274,1764602.3343466194,7552034
CA,101593708.35834907,1922,160,283767,1764762.3343466194,7835801
CA,101593708.35834907,1923,0,289785,1764762.3343466194,8125586
CA,101593708.35834907,1924,0,265269,1764762.3343466194,8390855
CA,101593708.35834907,1925,0,206964,1764762.3343466194,8597819
CA,101593708.35834907,1926,40,209241,1764802.3343466194,8807060
CA,101593708.35834907,1927,0,200930,1764802.3343466194,9007990
CA,101593708.35834907,1928,0,157444,1764802.3343466194,9165434
CA,101593708.35834907,1929,0,145624,1764802.3343466194,9311058
CA,101593708.35834907,1930,0,120205,1764802.3343466194,9431263
CO,66650971.27035877,1862,0,0,0,0
CO,66650971.27035877,1863,0,0,0,0
CO,66650971.27035877,1864,0,0,0,0
CO,66650971.27035877,1865,0,0,0,0
CO,66650971.27035877,1866,0,0,0,0
CO,66650971.27035877,1867,0,0,0,0
CO,66650971.27035877,1868,0,0,0,0
CO,66650971.27035877,1869,0,8837,0,8837
CO,66650971.27035877,1870,28460.69666666,11669,28460.69666666,20506
CO,66650971.27035877,1871,20372.193333330004,13223,48832.88999999,33729
CO,66650971.27035877,1872,68453.04999992003,10580,117285.93999991003,44309
CO,66650971.27035877,1873,73270.37000005005,15044,190556.30999996007,59353
CO,66650971.27035877,1874,33927.749999989996,13573,224484.05999995006,72926
CO,66650971.27035877,1875,4608.22000001,24533,229092.27999996007,97459
CO,66650971.27035877,1876,2867.7599999999998,35462,231960.03999996008,132921
CO,66650971.27035877,1877,3755.86,26489,235715.89999996006,159410
CO,66650971.27035877,1878,958.55,37479,236674.44999996005,196889
CO,66650971.27035877,1879,1000,42404,237674.44999996005,239293
CO,66650971.27035877,1880,480,58442,238154.44999996005,297735
CO,66650971.27035877,1881,880,70764,239034.44999996005,368499
CO,66650971.27035877,1882,876.61999999,78574,239911.06999995006,447073
CO,66650971.27035877,1883,516.39,107092,240427.45999995008,554165
CO,66650971.27035877,1884,3878.4097561,64303,244305.8697560501,618468
CO,66650971.27035877,1885,27799.5997561,58355,272105.4695121501,676823
CO,66650971.27035877,1886,30818.58360167,41591,302924.0531138201,718414
CO,66650971.27035877,1887,4379.88766667,49493,307303.9407804901,767907
CO,66650971.27035877,1888,3416.21458335,65675,310720.1553638401,833582
CO,66650971.27035877,1889,6997.81,97276,317717.9653638401,930858
CO,66650971.27035877,1890,10323.493999999999,113447,328041.4593638401,1044305
CO,66650971.27035877,1891,36.37,126817,328077.8293638401,1171122
CO,66650971.27035877,1892,0,144294,328077.8293638401,1315416
CO,66650971.27035877,1893,0,237808,328077.8293638401,1553224
CO,66650971.27035877,1894,0,222774,328077.8293638401,1775998
CO,66650971.27035877,1895,1755.54,174034,329833.3693638401,1950032
CO,66650971.27035877,1896,0,143640,329833.3693638401,2093672
CO,66650971.27035877,1897,0,101683,329833.3693638401,2195355
CO,66650971.27035877,1898,122.65800000000002,110887,329956.0273638401,2306242
CO,66650971.27035877,1899,0,138362,329956.0273638401,2444604
CO,66650971.27035877,1900,0,155268,329956.0273638401,2599872
CO,66650971.27035877,1901,0,133267,329956.0273638401,2733139
CO,66650971.27035877,1902,0,139149,329956.0273638401,2872288
CO,66650971.27035877,1903,0,116290,329956.0273638401,2988578
CO,66650971.27035877,1904,0,106679,329956.0273638401,3095257
CO,66650971.27035877,1905,0,137384,329956.0273638401,3232641
CO,66650971.27035877,1906,200,150030,330156.0273638401,3382671
CO,66650971.27035877,1907,97.795,188244,330253.82236384007,3570915
CO,66650971.27035877,1908,37.18,289824,330291.00236384006,3860739
CO,66650971.27035877,1909,48.43,293724,330339.43236384005,4154463
CO,66650971.27035877,1910,0,345183,330339.43236384005,4499646
CO,66650971.27035877,1911,0,353198,330339.43236384005,4852844
CO,66650971.27035877,1912,0,460222,330339.43236384005,5313066
CO,66650971.27035877,1913,0,1621484,330339.43236384005,6934550
CO,66650971.27035877,1914,0,1482382,330339.43236384005,8416932
CO,66650971.27035877,1915,18.47,928889,330357.90236384,9345821
CO,66650971.27035877,1916,0,767578,330357.90236384,10113399
CO,66650971.27035877,1917,15.94,1048996,330373.84236384,11162395
CO,66650971.27035877,1918,21.38,1138169,330395.22236384003,12300564
CO,66650971.27035877,1919,0,1209774,330395.22236384003,13510338
CO,66650971.27035877,1920,200,1617653,330595.22236384003,15127991
CO,66650971.27035877,1921,0,1244555,330595.22236384003,16372546
CO,66650971.27035877,1922,120,1220769,330715.22236384003,17593315
CO,66650971.27035877,1923,176.644,853981,330891.86636384,18447296
CO,66650971.27035877,1924,17.795,646608,330909.66136384,19093904
CO,66650971.27035877,1925,0,576716,330909.66136384,19670620
CO,66650971.27035877,1926,200.414,488046,331110.07536384,20158666
CO,66650971.27035877,1927,8.12,335026,331118.19536384,20493692
CO,66650971.27035877,1928,0,222384,331118.19536384,20716076
CO,66650971.27035877,1929,12.35,163427,331130.54536383995,20879503
CO,66650971.27035877,1930,0,138170,331130.54536383995,21017673
CT,3200218.068059834,1862,0,0,0,0
CT,3200218.068059834,1863,0,0,0,0
CT,3200218.068059834,1864,0,0,0,0
CT,3200218.068059834,1865,0,0,0,0
CT,3200218.068059834,1866,0,0,0,0
CT,3200218.068059834,1867,0,0,0,0
CT,3200218.068059834,1868,0,0,0,0
CT,3200218.068059834,1869,0,0,0,0
CT,3200218.068059834,1870,0,0,0,0
CT,3200218.068059834,1871,0,0,0,0
CT,3200218.068059834,1872,0,0,0,0
CT,3200218.068059834,1873,0,0,0,0
CT,3200218.068059834,1874,0,0,0,0
CT,3200218.068059834,1875,0,0,0,0
CT,3200218.068059834,1876,0,0,0,0
CT,3200218.068059834,1877,0,0,0,0
CT,3200218.068059834,1878,0,0,0,0
CT,3200218.068059834,1879,0,0,0,0
CT,3200218.068059834,1880,0,0,0,0
CT,3200218.068059834,1881,0,0,0,0
CT,3200218.068059834,1882,0,0,0,0
CT,3200218.068059834,1883,0,0,0,0
CT,3200218.068059834,1884,0,0,0,0
CT,3200218.068059834,1885,0,0,0,0
CT,3200218.068059834,1886,0,0,0,0
CT,3200218.068059834,1887,0,0,0,0
CT,3200218.068059834,1888,0,0,0,0
CT,3200218.068059834,1889,0,0,0,0
CT,3200218.068059834,1890,0,0,0,0
CT,3200218.068059834,1891,0,0,0,0
CT,3200218.068059834,1892,0,0,0,0
CT,3200218.068059834,1893,0,0,0,0
CT,3200218.068059834,1894,0,0,0,0
CT,3200218.068059834,1895,0,0,0,0
CT,3200218.068059834,1896,0,0,0,0
CT,3200218.068059834,1897,0,0,0,0
CT,3200218.068059834,1898,0,0,0,0
CT,3200218.068059834,1899,0,0,0,0
CT,3200218.068059834,1900,0,0,0,0
CT,3200218.068059834,1901,0,0,0,0
CT,3200218.068059834,1902,0,0,0,0
CT,3200218.068059834,1903,0,0,0,0
CT,3200218.068059834,1904,0,0,0,0
CT,3200218.068059834,1905,0,0,0,0
CT,3200218.068059834,1906,0,0,0,0
CT,3200218.068059834,1907,0,0,0,0
CT,3200218.068059834,1908,0,0,0,0
CT,3200218.068059834,1909,0,0,0,0
CT,3200218.068059834,1910,0,0,0,0
CT,3200218.068059834,1911,0,0,0,0
CT,3200218.068059834,1912,0,0,0,0
CT,3200218.068059834,1913,0,0,0,0
CT,3200218.068059834,1914,0,0,0,0
CT,3200218.068059834,1915,0,0,0,0
CT,3200218.068059834,1916,0,0,0,0
CT,3200218.068059834,1917,0,0,0,0
CT,3200218.068059834,1918,0,0,0,0
CT,3200218.068059834,1919,0,0,0,0
CT,3200218.068059834,1920,0,0,0,0
CT,3200218.068059834,1921,0,0,0,0
CT,3200218.068059834,1922,0,0,0,0
CT,3200218.068059834,1923,0,0,0,0
CT,3200218.068059834,1924,0,0,0,0
CT,3200218.068059834,1925,0,0,0,0
CT,3200218.068059834,1926,0,0,0,0
CT,3200218.068059834,1927,0,0,0,0
CT,3200218.068059834,1928,0,0,0,0
CT,3200218.068059834,1929,0,0,0,0
CT,3200218.068059834,1930,0,0,0,0
DE,1286866.7016035186,1862,0,0,0,0
DE,1286866.7016035186,1863,0,0,0,0
DE,1286866.7016035186,1864,0,0,0,0
DE,1286866.7016035186,1865,0,0,0,0
DE,1286866.7016035186,1866,0,0,0,0
DE,1286866.7016035186,1867,0,0,0,0
DE,1286866.7016035186,1868,0,0,0,0
DE,1286866.7016035186,1869,0,0,0,0
DE,1286866.7016035186,1870,0,0,0,0
DE,1286866.7016035186,1871,0,0,0,0
DE,1286866.7016035186,1872,0,0,0,0
DE,1286866.7016035186,1873,0,0,0,0
DE,1286866.7016035186,1874,0,0,0,0
DE,1286866.7016035186,1875,0,0,0,0
DE,1286866.7016035186,1876,0,0,0,0
DE,1286866.7016035186,1877,0,0,0,0
DE,1286866.7016035186,1878,0,0,0,0
DE,1286866.7016035186,1879,0,0,0,0
DE,1286866.7016035186,1880,0,0,0,0
DE,1286866.7016035186,1881,0,0,0,0
DE,1286866.7016035186,1882,0,0,0,0
DE,1286866.7016035186,1883,0,0,0,0
DE,1286866.7016035186,1884,0,0,0,0
DE,1286866.7016035186,1885,0,0,0,0
DE,1286866.7016035186,1886,0,0,0,0
DE,1286866.7016035186,1887,0,0,0,0
DE,1286866.7016035186,1888,0,0,0,0
DE,1286866.7016035186,1889,0,0,0,0
DE,1286866.7016035186,1890,0,0,0,0
DE,1286866.7016035186,1891,0,0,0,0
DE,1286866.7016035186,1892,0,0,0,0
DE,1286866.7016035186,1893,0,0,0,0
DE,1286866.7016035186,1894,0,0,0,0
DE,1286866.7016035186,1895,0,0,0,0
DE,1286866.7016035186,1896,0,0,0,0
DE,1286866.7016035186,1897,0,0,0,0
DE,1286866.7016035186,1898,0,0,0,0
DE,1286866.7016035186,1899,0,0,0,0
DE,1286866.7016035186,1900,0,0,0,0
DE,1286866.7016035186,1901,0,0,0,0
DE,1286866.7016035186,1902,0,0,0,0
DE,1286866.7016035186,1903,0,0,0,0
DE,1286866.7016035186,1904,0,0,0,0
DE,1286866.7016035186,1905,0,0,0,0
DE,1286866.7016035186,1906,0,0,0,0
DE,1286866.7016035186,1907,0,0,0,0
DE,1286866.7016035186,1908,0,0,0,0
DE,1286866.7016035186,1909,0,0,0,0
DE,1286866.7016035186,1910,0,0,0,0
DE,1286866.7016035186,1911,0,0,0,0
DE,1286866.7016035186,1912,0,0,0,0
DE,1286866.7016035186,1913,0,0,0,0
DE,1286866.7016035186,1914,0,0,0,0
DE,1286866.7016035186,1915,0,0,0,0
DE,1286866.7016035186,1916,0,0,0,0
DE,1286866.7016035186,1917,0,0,0,0
DE,1286866.7016035186,1918,0,0,0,0
DE,1286866.7016035186,1919,0,0,0,0
DE,1286866.7016035186,1920,0,0,0,0
DE,1286866.7016035186,1921,0,0,0,0
DE,1286866.7016035186,1922,0,0,0,0
DE,1286866.7016035186,1923,0,0,0,0
DE,1286866.7016035186,1924,0,0,0,0
DE,1286866.7016035186,1925,0,0,0,0
DE,1286866.7016035186,1926,0,0,0,0
DE,1286866.7016035186,1927,0,0,0,0
DE,1286866.7016035186,1928,0,0,0,0
DE,1286866.7016035186,1929,0,0,0,0
DE,1286866.7016035186,1930,0,0,0,0
FL,38544664.96057749,1862,0,0,0,0
FL,38544664.96057749,1863,0,0,0,0
FL,38544664.96057749,1864,0,0,0,0
FL,38544664.96057749,1865,0,0,0,0
FL,38544664.96057749,1866,0,0,0,0
FL,38544664.96057749,1867,0,0,0,0
FL,38544664.96057749,1868,0,0,0,0
FL,38544664.96057749,1869,0,0,0,0
FL,38544664.96057749,1870,0,0,0,0
FL,38544664.96057749,1871,0,0,0,0
FL,38544664.96057749,1872,0,1288,0,1288
FL,38544664.96057749,1873,0,2137,0,3425
FL,38544664.96057749,1874,0,32053,0,35478
FL,38544664.96057749,1875,0,31661,0,67139
FL,38544664.96057749,1876,0,28388,0,95527
FL,38544664.96057749,1877,0,17694,0,113221
FL,38544664.96057749,1878,0,23856,0,137077
FL,38544664.96057749,1879,0,22584,0,159661
FL,38544664.96057749,1880,0,33043,0,192704
FL,38544664.96057749,1881,0,69273,0,261977
FL,38544664.96057749,1882,160,91727,160,353704
FL,38544664.96057749,1883,0,90201,160,443905
FL,38544664.96057749,1884,0,68813,160,512718
FL,38544664.96057749,1885,0,58356,160,571074
FL,38544664.96057749,1886,0,56009,160,627083
FL,38544664.96057749,1887,0,46545,160,673628
FL,38544664.96057749,1888,0,104834,160,778462
FL,38544664.96057749,1889,0,81707,160,860169
FL,38544664.96057749,1890,0,125921,160,986090
FL,38544664.96057749,1891,0,127293,160,1113383
FL,38544664.96057749,1892,0,89524,160,1202907
FL,38544664.96057749,1893,0,77898,160,1280805
FL,38544664.96057749,1894,0,72122,160,1352927
FL,38544664.96057749,1895,0,79605,160,1432532
FL,38544664.96057749,1896,0,79218,160,1511750
FL,38544664.96057749,1897,0,95767,160,1607517
FL,38544664.96057749,1898,0,77529,160,1685046
FL,38544664.96057749,1899,0,83052,160,1768098
FL,38544664.96057749,1900,0,89852,160,1857950
FL,38544664.96057749,1901,0,90072,160,1948022
FL,38544664.96057749,1902,0,62762,160,2010784
FL,38544664.96057749,1903,799.87,55049,959.87,2065833
FL,38544664.96057749,1904,0,53557,959.87,2119390
FL,38544664.96057749,1905,0,77014,959.87,2196404
FL,38544664.96057749,1906,0,86362,959.87,2282766
FL,38544664.96057749,1907,0,50228,959.87,2332994
FL,38544664.96057749,1908,0,65589,959.87,2398583
FL,38544664.96057749,1909,0,62106,959.87,2460689
FL,38544664.96057749,1910,0,84270,959.87,2544959
FL,38544664.96057749,1911,0,91097,959.87,2636056
FL,38544664.96057749,1912,0,85495,959.87,2721551
FL,38544664.96057749,1913,0,72280,959.87,2793831
FL,38544664.96057749,1914,0,55908,959.87,2849739
FL,38544664.96057749,1915,0,43263,959.87,2893002
FL,38544664.96057749,1916,0,57978,959.87,2950980
FL,38544664.96057749,1917,0,67142,959.87,3018122
FL,38544664.96057749,1918,0,63002,959.87,3081124
FL,38544664.96057749,1919,0,33320,959.87,3114444
FL,38544664.96057749,1920,0,24485,959.87,3138929
FL,38544664.96057749,1921,0,19457,959.87,3158386
FL,38544664.96057749,1922,0,17213,959.87,3175599
FL,38544664.96057749,1923,0,13155,959.87,3188754
FL,38544664.96057749,1924,0,13780,959.87,3202534
FL,38544664.96057749,1925,0,13557,959.87,3216091
FL,38544664.96057749,1926,0,14881,959.87,3230972
FL,38544664.96057749,1927,0,43530,959.87,3274502
FL,38544664.96057749,1928,0,20982,959.87,3295484
FL,38544664.96057749,1929,0,12609,959.87,3308093
FL,38544664.96057749,1930,0,7236,959.87,3315329
GA,38187236.31201169,1862,0,0,0,0
GA,38187236.31201169,1863,0,0,0,0
GA,38187236.31201169,1864,0,0,0,0
GA,38187236.31201169,1865,0,0,0,0
GA,38187236.31201169,1866,0,0,0,0
GA,38187236.31201169,1867,0,0,0,0
GA,38187236.31201169,1868,0,0,0,0
GA,38187236.31201169,1869,0,0,0,0
GA,38187236.31201169,1870,0,0,0,0
GA,38187236.31201169,1871,0,0,0,0
GA,38187236.31201169,1872,0,0,0,0
GA,38187236.31201169,1873,0,0,0,0
GA,38187236.31201169,1874,0,0,0,0
GA,38187236.31201169,1875,0,0,0,0
GA,38187236.31201169,1876,0,0,0,0
GA,38187236.31201169,1877,0,0,0,0
GA,38187236.31201169,1878,0,0,0,0
GA,38187236.31201169,1879,0,0,0,0
GA,38187236.31201169,1880,0,0,0,0
GA,38187236.31201169,1881,0,0,0,0
GA,38187236.31201169,1882,0,0,0,0
GA,38187236.31201169,1883,0,0,0,0
GA,38187236.31201169,1884,0,0,0,0
GA,38187236.31201169,1885,0,0,0,0
GA,38187236.31201169,1886,0,0,0,0
GA,38187236.31201169,1887,0,0,0,0
GA,38187236.31201169,1888,0,0,0,0
GA,38187236.31201169,1889,0,0,0,0
GA,38187236.31201169,1890,0,0,0,0
GA,38187236.31201169,1891,0,0,0,0
GA,38187236.31201169,1892,0,0,0,0
GA,38187236.31201169,1893,0,0,0,0
GA,38187236.31201169,1894,0,0,0,0
GA,38187236.31201169,1895,0,0,0,0
GA,38187236.31201169,1896,0,0,0,0
GA,38187236.31201169,1897,0,0,0,0
GA,38187236.31201169,1898,0,0,0,0
GA,38187236.31201169,1899,0,0,0,0
GA,38187236.31201169,1900,0,0,0,0
GA,38187236.31201169,1901,0,0,0,0
GA,38187236.31201169,1902,0,0,0,0
GA,38187236.31201169,1903,0,0,0,0
GA,38187236.31201169,1904,0,0,0,0
GA,38187236.31201169,1905,0,0,0,0
GA,38187236.31201169,1906,0,0,0,0
GA,38187236.31201169,1907,0,0,0,0
GA,38187236.31201169,1908,0,0,0,0
GA,38187236.31201169,1909,0,0,0,0
GA,38187236.31201169,1910,0,0,0,0
GA,38187236.31201169,1911,0,0,0,0
GA,38187236.31201169,1912,0,0,0,0
GA,38187236.31201169,1913,0,0,0,0
GA,38187236.31201169,1914,0,0,0,0
GA,38187236.31201169,1915,0,0,0,0
GA,38187236.31201169,1916,0,0,0,0
GA,38187236.31201169,1917,0,0,0,0
GA,38187236.31201169,1918,0,0,0,0
GA,38187236.31201169,1919,0,0,0,0
GA,38187236.31201169,1920,0,0,0,0
GA,38187236.31201169,1921,0,0,0,0
GA,38187236.31201169,1922,0,0,0,0
GA,38187236.31201169,1923,0,0,0,0
GA,38187236.31201169,1924,0,0,0,0
GA,38187236.31201169,1925,0,0,0,0
GA,38187236.31201169,1926,0,0,0,0
GA,38187236.31201169,1927,0,0,0,0
GA,38187236.31201169,1928,0,0,0,0
GA,38187236.31201169,1929,0,0,0,0
GA,38187236.31201169,1930,0,0,0,0
IA,36121869.84781501,1862,197851.48,0,197851.48,0
IA,36121869.84781501,1863,0,0,197851.48,0
IA,36121869.84781501,1864,0,0,197851.48,0
IA,36121869.84781501,1865,0,0,197851.48,0
IA,36121869.84781501,1866,0,0,197851.48,0
IA,36121869.84781501,1867,160,0,198011.48,0
IA,36121869.84781501,1868,13280,8107,211291.48,8107
IA,36121869.84781501,1869,149635.88,12765,360927.36,20872
IA,36121869.84781501,1870,47342.38999999999,29652,408269.75,50524
IA,36121869.84781501,1871,9847.510000000002,39891,418117.26,90415
IA,36121869.84781501,1872,22069.35000001,33505,440186.61000001,123920
IA,36121869.84781501,1873,3200,75863,443386.61000001,199783
IA,36121869.84781501,1874,14485.95,84597,457872.56000001,284380
IA,36121869.84781501,1875,1760,137200,459632.56000001,421580
IA,36121869.84781501,1876,947.48,131744,460580.04000001,553324
IA,36121869.84781501,1877,456.87,118183,461036.91000001,671507
IA,36121869.84781501,1878,320,92350,461356.91000001,763857
IA,36121869.84781501,1879,0,49995,461356.91000001,813852
IA,36121869.84781501,1880,0,18116,461356.91000001,831968
IA,36121869.84781501,1881,0,8017,461356.91000001,839985
IA,36121869.84781501,1882,0,5482,461356.91000001,845467
IA,36121869.84781501,1883,0,5066,461356.91000001,850533
IA,36121869.84781501,1884,160,3618,461516.91000001,854151
IA,36121869.84781501,1885,0,2411,461516.91000001,856562
IA,36121869.84781501,1886,0,1890,461516.91000001,858452
IA,36121869.84781501,1887,0,1221,461516.91000001,859673
IA,36121869.84781501,1888,0,1422,461516.91000001,861095
IA,36121869.84781501,1889,0,1865,461516.91000001,862960
IA,36121869.84781501,1890,0,1000,461516.91000001,863960
IA,36121869.84781501,1891,0,2048,461516.91000001,866008
IA,36121869.84781501,1892,0,3586,461516.91000001,869594
IA,36121869.84781501,1893,0,11083,461516.91000001,880677
IA,36121869.84781501,1894,0,1098,461516.91000001,881775
IA,36121869.84781501,1895,160,1805,461676.91000001,883580
IA,36121869.84781501,1896,0,1640,461676.91000001,885220
IA,36121869.84781501,1897,0,1569,461676.91000001,886789
IA,36121869.84781501,1898,0,1049,461676.91000001,887838
IA,36121869.84781501,1899,0,1262,461676.91000001,889100
IA,36121869.84781501,1900,0,1456,461676.91000001,890556
IA,36121869.84781501,1901,0,8965,461676.91000001,899521
IA,36121869.84781501,1902,0,1520,461676.91000001,901041
IA,36121869.84781501,1903,0,547,461676.91000001,901588
IA,36121869.84781501,1904,0,410,461676.91000001,901998
IA,36121869.84781501,1905,0,49,461676.91000001,902047
IA,36121869.84781501,1906,0,699,461676.91000001,902746
IA,36121869.84781501,1907,0,207,461676.91000001,902953
IA,36121869.84781501,1908,0,109,461676.91000001,903062
IA,36121869.84781501,1909,0,52,461676.91000001,903114
IA,36121869.84781501,1910,0,80,461676.91000001,903194
IA,36121869.84781501,1911,0,0,461676.91000001,903194
IA,36121869.84781501,1912,0,0,461676.91000001,903194
IA,36121869.84781501,1913,0,0,461676.91000001,903194
IA,36121869.84781501,1914,0,0,461676.91000001,903194
IA,36121869.84781501,1915,0,0,461676.91000001,903194
IA,36121869.84781501,1916,0,0,461676.91000001,903194
IA,36121869.84781501,1917,0,0,461676.91000001,903194
IA,36121869.84781501,1918,0,0,461676.91000001,903194
IA,36121869.84781501,1919,0,0,461676.91000001,903194
IA,36121869.84781501,1920,0,0,461676.91000001,903194
IA,36121869.84781501,1921,0,0,461676.91000001,903194
IA,36121869.84781501,1922,0,0,461676.91000001,903194
IA,36121869.84781501,1923,0,0,461676.91000001,903194
IA,36121869.84781501,1924,0,0,461676.91000001,903194
IA,36121869.84781501,1925,0,0,461676.91000001,903194
IA,36121869.84781501,1926,0,0,461676.91000001,903194
IA,36121869.84781501,1927,0,0,461676.91000001,903194
IA,36121869.84781501,1928,0,0,461676.91000001,903194
IA,36121869.84781501,1929,0,0,461676.91000001,903194
IA,36121869.84781501,1930,0,0,461676.91000001,903194
ID,54000294.388454795,1862,0,0,0,0
ID,54000294.388454795,1863,0,0,0,0
ID,54000294.388454795,1864,0,0,0,0
ID,54000294.388454795,1865,0,0,0,0
ID,54000294.388454795,1866,0,0,0,0
ID,54000294.388454795,1867,0,0,0,0
ID,54000294.388454795,1868,0,0,0,0
ID,54000294.388454795,1869,0,0,0,0
ID,54000294.388454795,1870,0,0,0,0
ID,54000294.388454795,1871,0,0,0,0
ID,54000294.388454795,1872,0,0,0,0
ID,54000294.388454795,1873,0,1583,0,1583
ID,54000294.388454795,1874,0,2759,0,4342
ID,54000294.388454795,1875,160,4411,160,8753
ID,54000294.388454795,1876,0,7114,160,15867
ID,54000294.388454795,1877,0,5959,160,21826
ID,54000294.388454795,1878,0,7425,160,29251
ID,54000294.388454795,1879,0,9784,160,39035
ID,54000294.388454795,1880,0,27399,160,66434
ID,54000294.388454795,1881,0,15099,160,81533
ID,54000294.388454795,1882,0,17549,160,99082
ID,54000294.388454795,1883,0,26694,160,125776
ID,54000294.388454795,1884,0,32921,160,158697
ID,54000294.388454795,1885,0,32746,160,191443
ID,54000294.388454795,1886,0,38850,160,230293
ID,54000294.388454795,1887,0,45425,160,275718
ID,54000294.388454795,1888,0,47379,160,323097
ID,54000294.388454795,1889,0,61775,160,384872
ID,54000294.388454795,1890,0,83845,160,468717
ID,54000294.388454795,1891,0,68164,160,536881
ID,54000294.388454795,1892,11174.90950908,57273,11334.90950908,594154
ID,54000294.388454795,1893,3559.7975,61280,14894.70700908,655434
ID,54000294.388454795,1894,56606.93907756004,54969,71501.64608664004,710403
ID,54000294.388454795,1895,80,70110,71581.64608664004,780513
ID,54000294.388454795,1896,3767.54,65898,75349.18608664004,846411
ID,54000294.388454795,1897,200,75226,75549.18608664004,921637
ID,54000294.388454795,1898,2600.24,95553,78149.42608664004,1017190
ID,54000294.388454795,1899,2720,105149,80869.42608664004,1122339
ID,54000294.388454795,1900,0,108074,80869.42608664004,1230413
ID,54000294.388454795,1901,40,143680,80909.42608664004,1374093
ID,54000294.388454795,1902,2119.61,178456,83029.03608664004,1552549
ID,54000294.388454795,1903,0,189614,83029.03608664004,1742163
ID,54000294.388454795,1904,678.86476192,160319,83707.90084856005,1902482
ID,54000294.388454795,1905,3435.3528572000005,193482,87143.25370576006,2095964
ID,54000294.388454795,1906,209.37238096,208561,87352.62608672006,2304525
ID,54000294.388454795,1907,252.37,216534,87604.99608672006,2521059
ID,54000294.388454795,1908,0,213935,87604.99608672006,2734994
ID,54000294.388454795,1909,0,148381,87604.99608672006,2883375
ID,54000294.388454795,1910,0,206345,87604.99608672006,3089720
ID,54000294.388454795,1911,0,265200,87604.99608672006,3354920
ID,54000294.388454795,1912,0,221149,87604.99608672006,3576069
ID,54000294.388454795,1913,0,333547,87604.99608672006,3909616
ID,54000294.388454795,1914,0,321443,87604.99608672006,4231059
ID,54000294.388454795,1915,0,417949,87604.99608672006,4649008
ID,54000294.388454795,1916,0,515941,87604.99608672006,5164949
ID,54000294.388454795,1917,0,563269,87604.99608672006,5728218
ID,54000294.388454795,1918,0,598220,87604.99608672006,6326438
ID,54000294.388454795,1919,0,467437,87604.99608672006,6793875
ID,54000294.388454795,1920,0,489764,87604.99608672006,7283639
ID,54000294.388454795,1921,0,314449,87604.99608672006,7598088
ID,54000294.388454795,1922,0,327335,87604.99608672006,7925423
ID,54000294.388454795,1923,0,222386,87604.99608672006,8147809
ID,54000294.388454795,1924,0,192177,87604.99608672006,8339986
ID,54000294.388454795,1925,0,195897,87604.99608672006,8535883
ID,54000294.388454795,1926,0,163232,87604.99608672006,8699115
ID,54000294.388454795,1927,0,130664,87604.99608672006,8829779
ID,54000294.388454795,1928,0,67568,87604.99608672006,8897347
ID,54000294.388454795,1929,0,78494,87604.99608672006,8975841
ID,54000294.388454795,1930,0,69740,87604.99608672006,9045581
IL,36088981.28482454,1862,0,0,0,0
IL,36088981.28482454,1863,0,0,0,0
IL,36088981.28482454,1864,0,0,0,0
IL,36088981.28482454,1865,0,0,0,0
IL,36088981.28482454,1866,0,0,0,0
IL,36088981.28482454,1867,0,0,0,0
IL,36088981.28482454,1868,0,0,0,0
IL,36088981.28482454,1869,0,0,0,0
IL,36088981.28482454,1870,0,78,0,78
IL,36088981.28482454,1871,0,0,0,78
IL,36088981.28482454,1872,0,80,0,158
IL,36088981.28482454,1873,0,0,0,158
IL,36088981.28482454,1874,0,0,0,158
IL,36088981.28482454,1875,0,360,0,518
IL,36088981.28482454,1876,0,200,0,718
IL,36088981.28482454,1877,0,29,0,747
IL,36088981.28482454,1878,0,4007,0,4754
IL,36088981.28482454,1879,0,40,0,4794
IL,36088981.28482454,1880,0,0,0,4794
IL,36088981.28482454,1881,0,0,0,4794
IL,36088981.28482454,1882,0,377,0,5171
IL,36088981.28482454,1883,0,0,0,5171
IL,36088981.28482454,1884,0,0,0,5171
IL,36088981.28482454,1885,0,0,0,5171
IL,36088981.28482454,1886,0,0,0,5171
IL,36088981.28482454,1887,0,160,0,5331
IL,36088981.28482454,1888,0,0,0,5331
IL,36088981.28482454,1889,0,0,0,5331
IL,36088981.28482454,1890,0,0,0,5331
IL,36088981.28482454,1891,0,125,0,5456
IL,36088981.28482454,1892,0,0,0,5456
IL,36088981.28482454,1893,0,0,0,5456
IL,36088981.28482454,1894,0,45,0,5501
IL,36088981.28482454,1895,0,0,0,5501
IL,36088981.28482454,1896,0,0,0,5501
IL,36088981.28482454,1897,0,0,0,5501
IL,36088981.28482454,1898,0,0,0,5501
IL,36088981.28482454,1899,0,0,0,5501
IL,36088981.28482454,1900,0,0,0,5501
IL,36088981.28482454,1901,0,4,0,5505
IL,36088981.28482454,1902,0,0,0,5505
IL,36088981.28482454,1903,0,120,0,5625
IL,36088981.28482454,1904,0,0,0,5625
IL,36088981.28482454,1905,0,0,0,5625
IL,36088981.28482454,1906,0,0,0,5625
IL,36088981.28482454,1907,0,0,0,5625
IL,36088981.28482454,1908,0,0,0,5625
IL,36088981.28482454,1909,0,0,0,5625
IL,36088981.28482454,1910,0,0,0,5625
IL,36088981.28482454,1911,0,0,0,5625
IL,36088981.28482454,1912,0,0,0,5625
IL,36088981.28482454,1913,0,0,0,5625
IL,36088981.28482454,1914,0,0,0,5625
IL,36088981.28482454,1915,0,0,0,5625
IL,36088981.28482454,1916,0,0,0,5625
IL,36088981.28482454,1917,0,0,0,5625
IL,36088981.28482454,1918,0,0,0,5625
IL,36088981.28482454,1919,0,0,0,5625
IL,36088981.28482454,1920,0,0,0,5625
IL,36088981.28482454,1921,0,0,0,5625
IL,36088981.28482454,1922,0,0,0,5625
IL,36088981.28482454,1923,0,0,0,5625
IL,36088981.28482454,1924,0,0,0,5625
IL,36088981.28482454,1925,0,0,0,5625
IL,36088981.28482454,1926,0,0,0,5625
IL,36088981.28482454,1927,0,0,0,5625
IL,36088981.28482454,1928,0,0,0,5625
IL,36088981.28482454,1929,0,0,0,5625
IL,36088981.28482454,1930,0,0,0,5625
IN,23173802.32655728,1862,0,0,0,0
IN,23173802.32655728,1863,0,0,0,0
IN,23173802.32655728,1864,0,0,0,0
IN,23173802.32655728,1865,0,0,0,0
IN,23173802.32655728,1866,0,0,0,0
IN,23173802.32655728,1867,0,0,0,0
IN,23173802.32655728,1868,0,0,0,0
IN,23173802.32655728,1869,0,0,0,0
IN,23173802.32655728,1870,0,0,0,0
IN,23173802.32655728,1871,0,0,0,0
IN,23173802.32655728,1872,0,0,0,0
IN,23173802.32655728,1873,0,0,0,0
IN,23173802.32655728,1874,0,0,0,0
IN,23173802.32655728,1875,0,760,0,760
IN,23173802.32655728,1876,0,120,0,880
IN,23173802.32655728,1877,0,272,0,1152
IN,23173802.32655728,1878,0,120,0,1272
IN,23173802.32655728,1879,0,0,0,1272
IN,23173802.32655728,1880,0,0,0,1272
IN,23173802.32655728,1881,0,0,0,1272
IN,23173802.32655728,1882,0,0,0,1272
IN,23173802.32655728,1883,0,0,0,1272
IN,23173802.32655728,1884,0,0,0,1272
IN,23173802.32655728,1885,0,0,0,1272
IN,23173802.32655728,1886,0,120,0,1392
IN,23173802.32655728,1887,0,0,0,1392
IN,23173802.32655728,1888,0,0,0,1392
IN,23173802.32655728,1889,0,0,0,1392
IN,23173802.32655728,1890,0,0,0,1392
IN,23173802.32655728,1891,0,0,0,1392
IN,23173802.32655728,1892,0,0,0,1392
IN,23173802.32655728,1893,0,57,0,1449
IN,23173802.32655728,1894,0,40,0,1489
IN,23173802.32655728,1895,0,81,0,1570
IN,23173802.32655728,1896,0,40,0,1610
IN,23173802.32655728,1897,0,75,0,1685
IN,23173802.32655728,1898,0,6,0,1691
IN,23173802.32655728,1899,0,0,0,1691
IN,23173802.32655728,1900,0,42,0,1733
IN,23173802.32655728,1901,0,0,0,1733
IN,23173802.32655728,1902,0,0,0,1733
IN,23173802.32655728,1903,0,49,0,1782
IN,23173802.32655728,1904,0,0,0,1782
IN,23173802.32655728,1905,0,0,0,1782
IN,23173802.32655728,1906,0,0,0,1782
IN,23173802.32655728,1907,0,0,0,1782
IN,23173802.32655728,1908,0,0,0,1782
IN,23173802.32655728,1909,0,0,0,1782
IN,23173802.32655728,1910,0,0,0,1782
IN,23173802.32655728,1911,0,0,0,1782
IN,23173802.32655728,1912,0,0,0,1782
IN,23173802.32655728,1913,0,0,0,1782
IN,23173802.32655728,1914,0,0,0,1782
IN,23173802.32655728,1915,0,0,0,1782
IN,23173802.32655728,1916,0,0,0,1782
IN,23173802.32655728,1917,0,0,0,1782
IN,23173802.32655728,1918,0,0,0,1782
IN,23173802.32655728,1919,0,0,0,1782
IN,23173802.32655728,1920,0,0,0,1782
IN,23173802.32655728,1921,0,0,0,1782
IN,23173802.32655728,1922,0,0,0,1782
IN,23173802.32655728,1923,0,0,0,1782
IN,23173802.32655728,1924,0,0,0,1782
IN,23173802.32655728,1925,0,0,0,1782
IN,23173802.32655728,1926,0,0,0,1782
IN,23173802.32655728,1927,0,0,0,1782
IN,23173802.32655728,1928,0,0,0,1782
IN,23173802.32655728,1929,0,0,0,1782
IN,23173802.32655728,1930,0,0,0,1782
KS,52678369.13166625,1862,0,0,0,0
KS,52678369.13166625,1863,79337.34000000001,0,79337.34000000001,0
KS,52678369.13166625,1864,0,0,79337.34000000001,0
KS,52678369.13166625,1865,0,0,79337.34000000001,0
KS,52678369.13166625,1866,67306.65,0,146643.99,0
KS,52678369.13166625,1867,100726.52000000003,0,247370.51,0
KS,52678369.13166625,1868,101911.32999999999,68603,349281.83999999997,68603
KS,52678369.13166625,1869,168112.07999999996,48571,517393.9199999999,117174
KS,52678369.13166625,1870,158476.0699999999,37144,675869.9899999998,154318
KS,52678369.13166625,1871,5289.07,39347,681159.0599999997,193665
KS,52678369.13166625,1872,111212.64999999003,65086,792371.7099999897,258751
KS,52678369.13166625,1873,59523.43999999002,156270,851895.1499999798,415021
KS,52678369.13166625,1874,44843.860000009976,216674,896739.0099999898,631695
KS,52678369.13166625,1875,16382.289999999999,344880,913121.2999999898,976575
KS,52678369.13166625,1876,2678.31,457593,915799.6099999899,1434168
KS,52678369.13166625,1877,960,568153,916759.6099999899,2002321
KS,52678369.13166625,1878,630.65,670338,917390.2599999899,2672659
KS,52678369.13166625,1879,641.89,514816,918032.1499999899,3187475
KS,52678369.13166625,1880,1039.76,496713,919071.9099999899,3684188
KS,52678369.13166625,1881,720,477247,919791.9099999899,4161435
KS,52678369.13166625,1882,160,499300,919951.9099999899,4660735
KS,52678369.13166625,1883,0,506081,919951.9099999899,5166816
KS,52678369.13166625,1884,0,698272,919951.9099999899,5865088
KS,52678369.13166625,1885,800,601478,920751.9099999899,6466566
KS,52678369.13166625,1886,0,394388,920751.9099999899,6860954
KS,52678369.13166625,1887,0,306336,920751.9099999899,7167290
KS,52678369.13166625,1888,0,323903,920751.9099999899,7491193
KS,52678369.13166625,1889,0,302832,920751.9099999899,7794025
KS,52678369.13166625,1890,0,392004,920751.9099999899,8186029
KS,52678369.13166625,1891,0,588809,920751.9099999899,8774838
KS,52678369.13166625,1892,0,461525,920751.9099999899,9236363
KS,52678369.13166625,1893,0,452855,920751.9099999899,9689218
KS,52678369.13166625,1894,0,269153,920751.9099999899,9958371
KS,52678369.13166625,1895,0,165786,920751.9099999899,10124157
KS,52678369.13166625,1896,0,92014,920751.9099999899,10216171
KS,52678369.13166625,1897,0,95184,920751.9099999899,10311355
KS,52678369.13166625,1898,0,125954,920751.9099999899,10437309
KS,52678369.13166625,1899,160,130285,920911.9099999899,10567594
KS,52678369.13166625,1900,0,156980,920911.9099999899,10724574
KS,52678369.13166625,1901,0,92285,920911.9099999899,10816859
KS,52678369.13166625,1902,0,55812,920911.9099999899,10872671
KS,52678369.13166625,1903,0,43670,920911.9099999899,10916341
KS,52678369.13166625,1904,0,43182,920911.9099999899,10959523
KS,52678369.13166625,1905,0,52767,920911.9099999899,11012290
KS,52678369.13166625,1906,0,55385,920911.9099999899,11067675
KS,52678369.13166625,1907,0,76543,920911.9099999899,11144218
KS,52678369.13166625,1908,1264.52,167050,922176.4299999899,11311268
KS,52678369.13166625,1909,0,215462,922176.4299999899,11526730
KS,52678369.13166625,1910,0,195929,922176.4299999899,11722659
KS,52678369.13166625,1911,0,204399,922176.4299999899,11927058
KS,52678369.13166625,1912,0,234078,922176.4299999899,12161136
KS,52678369.13166625,1913,0,290516,922176.4299999899,12451652
KS,52678369.13166625,1914,0,139035,922176.4299999899,12590687
KS,52678369.13166625,1915,0,69069,922176.4299999899,12659756
KS,52678369.13166625,1916,0,42098,922176.4299999899,12701854
KS,52678369.13166625,1917,41.35,56539,922217.7799999899,12758393
KS,52678369.13166625,1918,41.35,43453,922259.1299999899,12801846
KS,52678369.13166625,1919,41.35,66892,922300.4799999899,12868738
KS,52678369.13166625,1920,0,100366,922300.4799999899,12969104
KS,52678369.13166625,1921,0,43570,922300.4799999899,13012674
KS,52678369.13166625,1922,0,41845,922300.4799999899,13054519
KS,52678369.13166625,1923,0,17796,922300.4799999899,13072315
KS,52678369.13166625,1924,0,8756,922300.4799999899,13081071
KS,52678369.13166625,1925,0,8187,922300.4799999899,13089258
KS,52678369.13166625,1926,0,0,922300.4799999899,13089258
KS,52678369.13166625,1927,0,0,922300.4799999899,13089258
KS,52678369.13166625,1928,0,0,922300.4799999899,13089258
KS,52678369.13166625,1929,0,0,922300.4799999899,13089258
KS,52678369.13166625,1930,0,0,922300.4799999899,13089258
KY,25883846.40951026,1862,0,0,0,0
KY,25883846.40951026,1863,0,0,0,0
KY,25883846.40951026,1864,0,0,0,0
KY,25883846.40951026,1865,0,0,0,0
KY,25883846.40951026,1866,0,0,0,0
KY,25883846.40951026,1867,0,0,0,0
KY,25883846.40951026,1868,0,0,0,0
KY,25883846.40951026,1869,0,0,0,0
KY,25883846.40951026,1870,0,0,0,0
KY,25883846.40951026,1871,0,0,0,0
KY,25883846.40951026,1872,0,0,0,0
KY,25883846.40951026,1873,0,0,0,0
KY,25883846.40951026,1874,0,0,0,0
KY,25883846.40951026,1875,0,0,0,0
KY,25883846.40951026,1876,0,0,0,0
KY,25883846.40951026,1877,0,0,0,0
KY,25883846.40951026,1878,0,0,0,0
KY,25883846.40951026,1879,0,0,0,0
KY,25883846.40951026,1880,0,0,0,0
KY,25883846.40951026,1881,0,0,0,0
KY,25883846.40951026,1882,0,0,0,0
KY,25883846.40951026,1883,0,0,0,0
KY,25883846.40951026,1884,0,0,0,0
KY,25883846.40951026,1885,0,0,0,0
KY,25883846.40951026,1886,0,0,0,0
KY,25883846.40951026,1887,0,0,0,0
KY,25883846.40951026,1888,0,0,0,0
KY,25883846.40951026,1889,0,0,0,0
KY,25883846.40951026,1890,0,0,0,0
KY,25883846.40951026,1891,0,0,0,0
KY,25883846.40951026,1892,0,0,0,0
KY,25883846.40951026,1893,0,0,0,0
KY,25883846.40951026,1894,0,0,0,0
KY,25883846.40951026,1895,0,0,0,0
KY,25883846.40951026,1896,0,0,0,0
KY,25883846.40951026,1897,0,0,0,0
KY,25883846.40951026,1898,0,0,0,0
KY,25883846.40951026,1899,0,0,0,0
KY,25883846.40951026,1900,0,0,0,0
KY,25883846.40951026,1901,0,0,0,0
KY,25883846.40951026,1902,0,0,0,0
KY,25883846.40951026,1903,0,0,0,0
KY,25883846.40951026,1904,0,0,0,0
KY,25883846.40951026,1905,0,0,0,0
KY,25883846.40951026,1906,0,0,0,0
KY,25883846.40951026,1907,0,0,0,0
KY,25883846.40951026,1908,0,0,0,0
KY,25883846.40951026,1909,0,0,0,0
KY,25883846.40951026,1910,0,0,0,0
KY,25883846.40951026,1911,0,0,0,0
KY,25883846.40951026,1912,0,0,0,0
KY,25883846.40951026,1913,0,0,0,0
KY,25883846.40951026,1914,0,0,0,0
KY,25883846.40951026,1915,0,0,0,0
KY,25883846.40951026,1916,0,0,0,0
KY,25883846.40951026,1917,0,0,0,0
KY,25883846.40951026,1918,0,0,0,0
KY,25883846.40951026,1919,0,0,0,0
KY,25883846.40951026,1920,0,0,0,0
KY,25883846.40951026,1921,0,0,0,0
KY,25883846.40951026,1922,0,0,0,0
KY,25883846.40951026,1923,0,0,0,0
KY,25883846.40951026,1924,0,0,0,0
KY,25883846.40951026,1925,0,0,0,0
KY,25883846.40951026,1926,0,0,0,0
KY,25883846.40951026,1927,0,0,0,0
KY,25883846.40951026,1928,0,0,0,0
KY,25883846.40951026,1929,0,0,0,0
KY,25883846.40951026,1930,0,0,0,0
LA,30741827.289905928,1862,0,0,0,0
LA,30741827.289905928,1863,0,0,0,0
LA,30741827.289905928,1864,0,0,0,0
LA,30741827.289905928,1865,0,0,0,0
LA,30741827.289905928,1866,0,0,0,0
LA,30741827.289905928,1867,0,0,0,0
LA,30741827.289905928,1868,0,0,0,0
LA,30741827.289905928,1869,0,0,0,0
LA,30741827.289905928,1870,0,0,0,0
LA,30741827.289905928,1871,0,0,0,0
LA,30741827.289905928,1872,0,703,0,703
LA,30741827.289905928,1873,0,402,0,1105
LA,30741827.289905928,1874,0,3872,0,4977
LA,30741827.289905928,1875,0,21094,0,26071
LA,30741827.289905928,1876,0,30356,0,56427
LA,30741827.289905928,1877,0,43432,0,99859
LA,30741827.289905928,1878,0,51340,0,151199
LA,30741827.289905928,1879,0,41046,0,192245
LA,30741827.289905928,1880,0,25280,0,217525
LA,30741827.289905928,1881,0,26470,0,243995
LA,30741827.289905928,1882,0,20737,0,264732
LA,30741827.289905928,1883,0,20997,0,285729
LA,30741827.289905928,1884,0,21975,0,307704
LA,30741827.289905928,1885,0,28046,0,335750
LA,30741827.289905928,1886,0,18468,0,354218
LA,30741827.289905928,1887,0,31287,0,385505
LA,30741827.289905928,1888,0,31573,0,417078
LA,30741827.289905928,1889,0,86144,0,503222
LA,30741827.289905928,1890,0,97443,0,600665
LA,30741827.289905928,1891,0,73511,0,674176
LA,30741827.289905928,1892,0,96522,0,770698
LA,30741827.289905928,1893,0,86303,0,857001
LA,30741827.289905928,1894,0,77261,0,934262
LA,30741827.289905928,1895,0,96736,0,1030998
LA,30741827.289905928,1896,0,105022,0,1136020
LA,30741827.289905928,1897,0,161466,0,1297486
LA,30741827.289905928,1898,0,105890,0,1403376
LA,30741827.289905928,1899,159.56,106531,159.56,1509907
LA,30741827.289905928,1900,0,113822,159.56,1623729
LA,30741827.289905928,1901,158.72,127751,318.28,1751480
LA,30741827.289905928,1902,0,130335,318.28,1881815
LA,30741827.289905928,1903,325.59000000000003,105300,643.87,1987115
LA,30741827.289905928,1904,0,53133,643.87,2040248
LA,30741827.289905928,1905,0,83453,643.87,2123701
LA,30741827.289905928,1906,0,74484,643.87,2198185
LA,30741827.289905928,1907,0,64323,643.87,2262508
LA,30741827.289905928,1908,0,60311,643.87,2322819
LA,30741827.289905928,1909,0,41720,643.87,2364539
LA,30741827.289905928,1910,0,27198,643.87,2391737
LA,30741827.289905928,1911,0,29317,643.87,2421054
LA,30741827.289905928,1912,0,22812,643.87,2443866
LA,30741827.289905928,1913,0,23204,643.87,2467070
LA,30741827.289905928,1914,0,14577,643.87,2481647
LA,30741827.289905928,1915,0,10922,643.87,2492569
LA,30741827.289905928,1916,0,10230,643.87,2502799
LA,30741827.289905928,1917,0,11323,643.87,2514122
LA,30741827.289905928,1918,0,11261,643.87,2525383
LA,30741827.289905928,1919,0,9407,643.87,2534790
LA,30741827.289905928,1920,0,5123,643.87,2539913
LA,30741827.289905928,1921,0,2869,643.87,2542782
LA,30741827.289905928,1922,0,6046,643.87,2548828
LA,30741827.289905928,1923,0,3083,643.87,2551911
LA,30741827.289905928,1924,0,3516,643.87,2555427
LA,30741827.289905928,1925,0,1990,643.87,2557417
LA,30741827.289905928,1926,0,1434,643.87,2558851
LA,30741827.289905928,1927,0,1098,643.87,2559949
LA,30741827.289905928,1928,0,0,643.87,2559949
LA,30741827.289905928,1929,0,0,643.87,2559949
LA,30741827.289905928,1930,0,0,643.87,2559949
MA,5260537.206450875,1862,0,0,0,0
MA,5260537.206450875,1863,0,0,0,0
MA,5260537.206450875,1864,0,0,0,0
MA,5260537.206450875,1865,0,0,0,0
MA,5260537.206450875,1866,0,0,0,0
MA,5260537.206450875,1867,0,0,0,0
MA,5260537.206450875,1868,0,0,0,0
MA,5260537.206450875,1869,0,0,0,0
MA,5260537.206450875,1870,0,0,0,0
MA,5260537.206450875,1871,0,0,0,0
MA,5260537.206450875,1872,0,0,0,0
MA,5260537.206450875,1873,0,0,0,0
MA,5260537.206450875,1874,0,0,0,0
MA,5260537.206450875,1875,0,0,0,0
MA,5260537.206450875,1876,0,0,0,0
MA,5260537.206450875,1877,0,0,0,0
MA,5260537.206450875,1878,0,0,0,0
MA,5260537.206450875,1879,0,0,0,0
MA,5260537.206450875,1880,0,0,0,0
MA,5260537.206450875,1881,0,0,0,0
MA,5260537.206450875,1882,0,0,0,0
MA,5260537.206450875,1883,0,0,0,0
MA,5260537.206450875,1884,0,0,0,0
MA,5260537.206450875,1885,0,0,0,0
MA,5260537.206450875,1886,0,0,0,0
MA,5260537.206450875,1887,0,0,0,0
MA,5260537.206450875,1888,0,0,0,0
MA,5260537.206450875,1889,0,0,0,0
MA,5260537.206450875,1890,0,0,0,0
MA,5260537.206450875,1891,0,0,0,0
MA,5260537.206450875,1892,0,0,0,0
MA,5260537.206450875,1893,0,0,0,0
MA,5260537.206450875,1894,0,0,0,0
MA,5260537.206450875,1895,0,0,0,0
MA,5260537.206450875,1896,0,0,0,0
MA,5260537.206450875,1897,0,0,0,0
MA,5260537.206450875,1898,0,0,0,0
MA,5260537.206450875,1899,0,0,0,0
MA,5260537.206450875,1900,0,0,0,0
MA,5260537.206450875,1901,0,0,0,0
MA,5260537.206450875,1902,0,0,0,0
MA,5260537.206450875,1903,0,0,0,0
MA,5260537.206450875,1904,0,0,0,0
MA,5260537.206450875,1905,0,0,0,0
MA,5260537.206450875,1906,0,0,0,0
MA,5260537.206450875,1907,0,0,0,0
MA,5260537.206450875,1908,0,0,0,0
MA,5260537.206450875,1909,0,0,0,0
MA,5260537.206450875,1910,0,0,0,0
MA,5260537.206450875,1911,0,0,0,0
MA,5260537.206450875,1912,0,0,0,0
MA,5260537.206450875,1913,0,0,0,0
MA,5260537.206450875,1914,0,0,0,0
MA,5260537.206450875,1915,0,0,0,0
MA,5260537.206450875,1916,0,0,0,0
MA,5260537.206450875,1917,0,0,0,0
MA,5260537.206450875,1918,0,0,0,0
MA,5260537.206450875,1919,0,0,0,0
MA,5260537.206450875,1920,0,0,0,0
MA,5260537.206450875,1921,0,0,0,0
MA,5260537.206450875,1922,0,0,0,0
MA,5260537.206450875,1923,0,0,0,0
MA,5260537.206450875,1924,0,0,0,0
MA,5260537.206450875,1925,0,0,0,0
MA,5260537.206450875,1926,0,0,0,0
MA,5260537.206450875,1927,0,0,0,0
MA,5260537.206450875,1928,0,0,0,0
MA,5260537.206450875,1929,0,0,0,0
MA,5260537.206450875,1930,0,0,0,0
MD,6585224.567902835,1862,0,0,0,0
MD,6585224.567902835,1863,0,0,0,0
MD,6585224.567902835,1864,0,0,0,0
MD,6585224.567902835,1865,0,0,0,0
MD,6585224.567902835,1866,0,0,0,0
MD,6585224.567902835,1867,0,0,0,0
MD,6585224.567902835,1868,0,0,0,0
MD,6585224.567902835,1869,0,0,0,0
MD,6585224.567902835,1870,0,0,0,0
MD,6585224.567902835,1871,0,0,0,0
MD,6585224.567902835,1872,0,0,0,0
MD,6585224.567902835,1873,0,0,0,0
MD,6585224.567902835,1874,0,0,0,0
MD,6585224.567902835,1875,0,0,0,0
MD,6585224.567902835,1876,0,0,0,0
MD,6585224.567902835,1877,0,0,0,0
MD,6585224.567902835,1878,0,0,0,0
MD,6585224.567902835,1879,0,0,0,0
MD,6585224.567902835,1880,0,0,0,0
MD,6585224.567902835,1881,0,0,0,0
MD,6585224.567902835,1882,0,0,0,0
MD,6585224.567902835,1883,0,0,0,0
MD,6585224.567902835,1884,0,0,0,0
MD,6585224.567902835,1885,0,0,0,0
MD,6585224.567902835,1886,0,0,0,0
MD,6585224.567902835,1887,0,0,0,0
MD,6585224.567902835,1888,0,0,0,0
MD,6585224.567902835,1889,0,0,0,0
MD,6585224.567902835,1890,0,0,0,0
MD,6585224.567902835,1891,0,0,0,0
MD,6585224.567902835,1892,0,0,0,0
MD,6585224.567902835,1893,0,0,0,0
MD,6585224.567902835,1894,0,0,0,0
MD,6585224.567902835,1895,0,0,0,0
MD,6585224.567902835,1896,0,0,0,0
MD,6585224.567902835,1897,0,0,0,0
MD,6585224.567902835,1898,0,0,0,0
MD,6585224.567902835,1899,0,0,0,0
MD,6585224.567902835,1900,0,0,0,0
MD,6585224.567902835,1901,0,0,0,0
MD,6585224.567902835,1902,0,0,0,0
MD,6585224.567902835,1903,0,0,0,0
MD,6585224.567902835,1904,0,0,0,0
MD,6585224.567902835,1905,0,0,0,0
MD,6585224.567902835,1906,0,0,0,0
MD,6585224.567902835,1907,0,0,0,0
MD,6585224.567902835,1908,0,0,0,0
MD,6585224.567902835,1909,0,0,0,0
MD,6585224.567902835,1910,0,0,0,0
MD,6585224.567902835,1911,0,0,0,0
MD,6585224.567902835,1912,0,0,0,0
MD,6585224.567902835,1913,0,0,0,0
MD,6585224.567902835,1914,0,0,0,0
MD,6585224.567902835,1915,0,0,0,0
MD,6585224.567902835,1916,0,0,0,0
MD,6585224.567902835,1917,0,0,0,0
MD,6585224.567902835,1918,0,0,0,0
MD,6585224.567902835,1919,0,0,0,0
MD,6585224.567902835,1920,0,0,0,0
MD,6585224.567902835,1921,0,0,0,0
MD,6585224.567902835,1922,0,0,0,0
MD,6585224.567902835,1923,0,0,0,0
MD,6585224.567902835,1924,0,0,0,0
MD,6585224.567902835,1925,0,0,0,0
MD,6585224.567902835,1926,0,0,0,0
MD,6585224.567902835,1927,0,0,0,0
MD,6585224.567902835,1928,0,0,0,0
MD,6585224.567902835,1929,0,0,0,0
MD,6585224.567902835,1930,0,0,0,0
ME,21245880.84412982,1862,0,0,0,0
ME,21245880.84412982,1863,0,0,0,0
ME,21245880.84412982,1864,0,0,0,0
ME,21245880.84412982,1865,0,0,0,0
ME,21245880.84412982,1866,0,0,0,0
ME,21245880.84412982,1867,0,0,0,0
ME,21245880.84412982,1868,0,0,0,0
ME,21245880.84412982,1869,0,0,0,0
ME,21245880.84412982,1870,0,0,0,0
ME,21245880.84412982,1871,0,0,0,0
ME,21245880.84412982,1872,0,0,0,0
ME,21245880.84412982,1873,0,0,0,0
ME,21245880.84412982,1874,0,0,0,0
ME,21245880.84412982,1875,0,0,0,0
ME,21245880.84412982,1876,0,0,0,0
ME,21245880.84412982,1877,0,0,0,0
ME,21245880.84412982,1878,0,0,0,0
ME,21245880.84412982,1879,0,0,0,0
ME,21245880.84412982,1880,0,0,0,0
ME,21245880.84412982,1881,0,0,0,0
ME,21245880.84412982,1882,0,0,0,0
ME,21245880.84412982,1883,0,0,0,0
ME,21245880.84412982,1884,0,0,0,0
ME,21245880.84412982,1885,0,0,0,0
ME,21245880.84412982,1886,0,0,0,0
ME,21245880.84412982,1887,0,0,0,0
ME,21245880.84412982,1888,0,0,0,0
ME,21245880.84412982,1889,0,0,0,0
ME,21245880.84412982,1890,0,0,0,0
ME,21245880.84412982,1891,0,0,0,0
ME,21245880.84412982,1892,0,0,0,0
ME,21245880.84412982,1893,0,0,0,0
ME,21245880.84412982,1894,0,0,0,0
ME,21245880.84412982,1895,0,0,0,0
ME,21245880.84412982,1896,0,0,0,0
ME,21245880.84412982,1897,0,0,0,0
ME,21245880.84412982,1898,0,0,0,0
ME,21245880.84412982,1899,0,0,0,0
ME,21245880.84412982,1900,0,0,0,0
ME,21245880.84412982,1901,0,0,0,0
ME,21245880.84412982,1902,0,0,0,0
ME,21245880.84412982,1903,0,0,0,0
ME,21245880.84412982,1904,0,0,0,0
ME,21245880.84412982,1905,0,0,0,0
ME,21245880.84412982,1906,0,0,0,0
ME,21245880.84412982,1907,0,0,0,0
ME,21245880.84412982,1908,0,0,0,0
ME,21245880.84412982,1909,0,0,0,0
ME,21245880.84412982,1910,0,0,0,0
ME,21245880.84412982,1911,0,0,0,0
ME,21245880.84412982,1912,0,0,0,0
ME,21245880.84412982,1913,0,0,0,0
ME,21245880.84412982,1914,0,0,0,0
ME,21245880.84412982,1915,0,0,0,0
ME,21245880.84412982,1916,0,0,0,0
ME,21245880.84412982,1917,0,0,0,0
ME,21245880.84412982,1918,0,0,0,0
ME,21245880.84412982,1919,0,0,0,0
ME,21245880.84412982,1920,0,0,0,0
ME,21245880.84412982,1921,0,0,0,0
ME,21245880.84412982,1922,0,0,0,0
ME,21245880.84412982,1923,0,0,0,0
ME,21245880.84412982,1924,0,0,0,0
ME,21245880.84412982,1925,0,0,0,0
ME,21245880.84412982,1926,0,0,0,0
ME,21245880.84412982,1927,0,0,0,0
ME,21245880.84412982,1928,0,0,0,0
ME,21245880.84412982,1929,0,0,0,0
ME,21245880.84412982,1930,0,0,0,0
MI,37649175.2880441,1862,0,0,0,0
MI,37649175.2880441,1863,228986.72,0,228986.72,0
MI,37649175.2880441,1864,0,0,228986.72,0
MI,37649175.2880441,1865,171.05499999999998,0,229157.775,0
MI,37649175.2880441,1866,233725.35499999998,0,462883.13,0
MI,37649175.2880441,1867,136572.21,0,599455.34,0
MI,37649175.2880441,1868,251066.12000000023,61403,850521.4600000002,61403
MI,37649175.2880441,1869,157384.09999999995,78139,1007905.5600000002,139542
MI,37649175.2880441,1870,126391.19999999994,43082,1134296.76,182624
MI,37649175.2880441,1871,292.4,84022,1134589.16,266646
MI,37649175.2880441,1872,3189.58,105560,1137778.74,372206
MI,37649175.2880441,1873,6689.260000000001,132773,1144468,504979
MI,37649175.2880441,1874,480,108666,1144948,613645
MI,37649175.2880441,1875,1558.1599999999999,98850,1146506.16,712495
MI,37649175.2880441,1876,973.43,112501,1147479.5899999999,824996
MI,37649175.2880441,1877,879.52,90094,1148359.1099999999,915090
MI,37649175.2880441,1878,320,124988,1148679.1099999999,1040078
MI,37649175.2880441,1879,160,71711,1148839.1099999999,1111789
MI,37649175.2880441,1880,0,74584,1148839.1099999999,1186373
MI,37649175.2880441,1881,160.4,81846,1148999.5099999998,1268219
MI,37649175.2880441,1882,0,70156,1148999.5099999998,1338375
MI,37649175.2880441,1883,640,59569,1149639.5099999998,1397944
MI,37649175.2880441,1884,40,69589,1149679.5099999998,1467533
MI,37649175.2880441,1885,0,50435,1149679.5099999998,1517968
MI,37649175.2880441,1886,320,56513,1149999.5099999998,1574481
MI,37649175.2880441,1887,0,48046,1149999.5099999998,1622527
MI,37649175.2880441,1888,160,48711,1150159.5099999998,1671238
MI,37649175.2880441,1889,0,47543,1150159.5099999998,1718781
MI,37649175.2880441,1890,0,42582,1150159.5099999998,1761363
MI,37649175.2880441,1891,0,34970,1150159.5099999998,1796333
MI,37649175.2880441,1892,0,26877,1150159.5099999998,1823210
MI,37649175.2880441,1893,0,27437,1150159.5099999998,1850647
MI,37649175.2880441,1894,0,33611,1150159.5099999998,1884258
MI,37649175.2880441,1895,160,24475,1150319.5099999998,1908733
MI,37649175.2880441,1896,0,22506,1150319.5099999998,1931239
MI,37649175.2880441,1897,0,23448,1150319.5099999998,1954687
MI,37649175.2880441,1898,0,29338,1150319.5099999998,1984025
MI,37649175.2880441,1899,0,28534,1150319.5099999998,2012559
MI,37649175.2880441,1900,0,26101,1150319.5099999998,2038660
MI,37649175.2880441,1901,0,22780,1150319.5099999998,2061440
MI,37649175.2880441,1902,0,20830,1150319.5099999998,2082270
MI,37649175.2880441,1903,0,16096,1150319.5099999998,2098366
MI,37649175.2880441,1904,80,16025,1150399.5099999998,2114391
MI,37649175.2880441,1905,0,21472,1150399.5099999998,2135863
MI,37649175.2880441,1906,80,20342,1150479.5099999998,2156205
MI,37649175.2880441,1907,0,13885,1150479.5099999998,2170090
MI,37649175.2880441,1908,0,12553,1150479.5099999998,2182643
MI,37649175.2880441,1909,0,15336,1150479.5099999998,2197979
MI,37649175.2880441,1910,0,16443,1150479.5099999998,2214422
MI,37649175.2880441,1911,0,10681,1150479.5099999998,2225103
MI,37649175.2880441,1912,0,10669,1150479.5099999998,2235772
MI,37649175.2880441,1913,0,14003,1150479.5099999998,2249775
MI,37649175.2880441,1914,0,11438,1150479.5099999998,2261213
MI,37649175.2880441,1915,0,8298,1150479.5099999998,2269511
MI,37649175.2880441,1916,0,9830,1150479.5099999998,2279341
MI,37649175.2880441,1917,0,8199,1150479.5099999998,2287540
MI,37649175.2880441,1918,0,7953,1150479.5099999998,2295493
MI,37649175.2880441,1919,0,4895,1150479.5099999998,2300388
MI,37649175.2880441,1920,0,4060,1150479.5099999998,2304448
MI,37649175.2880441,1921,0,5449,1150479.5099999998,2309897
MI,37649175.2880441,1922,0,2423,1150479.5099999998,2312320
MI,37649175.2880441,1923,0,4320,1150479.5099999998,2316640
MI,37649175.2880441,1924,0,3218,1150479.5099999998,2319858
MI,37649175.2880441,1925,0,1747,1150479.5099999998,2321605
MI,37649175.2880441,1926,0,0,1150479.5099999998,2321605
MI,37649175.2880441,1927,0,0,1150479.5099999998,2321605
MI,37649175.2880441,1928,0,0,1150479.5099999998,2321605
MI,37649175.2880441,1929,0,0,1150479.5099999998,2321605
MI,37649175.2880441,1930,0,0,1150479.5099999998,2321605
MN,54944591.84951174,1862,0,0,0,0
MN,54944591.84951174,1863,0,0,0,0
MN,54944591.84951174,1864,0,0,0,0
MN,54944591.84951174,1865,2916.43,0,2916.43,0
MN,54944591.84951174,1866,98387.86000000995,0,101304.29000000995,0
MN,54944591.84951174,1867,180701.77000004,0,282006.06000004994,0
MN,54944591.84951174,1868,276447.4000000299,113800,558453.4600000798,113800
MN,54944591.84951174,1869,83134.40999998,164844,641587.8700000598,278644
MN,54944591.84951174,1870,142004.55999999,212388,783592.4300000498,491032
MN,54944591.84951174,1871,43571.83999999999,189647,827164.2700000497,680679
MN,54944591.84951174,1872,44291.03500000999,181678,871455.3050000598,862357
MN,54944591.84951174,1873,62942.43500003002,255648,934397.7400000897,1118005
MN,54944591.84951174,1874,54370.950000009994,318319,988768.6900000997,1436324
MN,54944591.84951174,1875,9904.975000000002,353296,998673.6650000997,1789620
MN,54944591.84951174,1876,3616.3216666999992,363074,1002289.9866667996,2152694
MN,54944591.84951174,1877,2745.1933333299994,286019,1005035.1800001296,2438713
MN,54944591.84951174,1878,1139.45,302651,1006174.6300001296,2741364
MN,54944591.84951174,1879,1223.25,262968,1007397.8800001296,3004332
MN,54944591.84951174,1880,1070,219932,1008467.8800001296,3224264
MN,54944591.84951174,1881,1889.6399999999999,202801,1010357.5200001296,3427065
MN,54944591.84951174,1882,1176.1,245647,1011533.6200001296,3672712
MN,54944591.84951174,1883,640,286239,1012173.6200001296,3958951
MN,54944591.84951174,1884,433.5,303340,1012607.1200001296,4262291
MN,54944591.84951174,1885,0,367227,1012607.1200001296,4629518
MN,54944591.84951174,1886,2051.99166667,300233,1014659.1116667995,4929751
MN,54944591.84951174,1887,418.79999999999995,276613,1015077.9116667996,5206364
MN,54944591.84951174,1888,1064.035,212678,1016141.9466667996,5419042
MN,54944591.84951174,1889,203.01333333,326127,1016344.9600001296,5745169
MN,54944591.84951174,1890,1301.8499999800001,227700,1017646.8100001096,5972869
MN,54944591.84951174,1891,0,156481,1017646.8100001096,6129350
MN,54944591.84951174,1892,0,126607,1017646.8100001096,6255957
MN,54944591.84951174,1893,0,148047,1017646.8100001096,6404004
MN,54944591.84951174,1894,160,112892,1017806.8100001096,6516896
MN,54944591.84951174,1895,1524.2599999999998,100659,1019331.0700001096,6617555
MN,54944591.84951174,1896,0,87141,1019331.0700001096,6704696
MN,54944591.84951174,1897,760,100820,1020091.0700001096,6805516
MN,54944591.84951174,1898,0,179654,1020091.0700001096,6985170
MN,54944591.84951174,1899,320,155654,1020411.0700001096,7140824
MN,54944591.84951174,1900,0,199227,1020411.0700001096,7340051
MN,54944591.84951174,1901,0,259944,1020411.0700001096,7599995
MN,54944591.84951174,1902,160,295127,1020571.0700001096,7895122
MN,54944591.84951174,1903,0,291358,1020571.0700001096,8186480
MN,54944591.84951174,1904,0,197309,1020571.0700001096,8383789
MN,54944591.84951174,1905,0,239233,1020571.0700001096,8623022
MN,54944591.84951174,1906,160,234350,1020731.0700001096,8857372
MN,54944591.84951174,1907,0,214781,1020731.0700001096,9072153
MN,54944591.84951174,1908,0,252260,1020731.0700001096,9324413
MN,54944591.84951174,1909,0,248395,1020731.0700001096,9572808
MN,54944591.84951174,1910,0,199518,1020731.0700001096,9772326
MN,54944591.84951174,1911,0,160574,1020731.0700001096,9932900
MN,54944591.84951174,1912,0,65061,1020731.0700001096,9997961
MN,54944591.84951174,1913,0,71415,1020731.0700001096,10069376
MN,54944591.84951174,1914,0,58322,1020731.0700001096,10127698
MN,54944591.84951174,1915,0,41017,1020731.0700001096,10168715
MN,54944591.84951174,1916,0,35627,1020731.0700001096,10204342
MN,54944591.84951174,1917,0,43675,1020731.0700001096,10248017
MN,54944591.84951174,1918,0,28809,1020731.0700001096,10276826
MN,54944591.84951174,1919,0,34002,1020731.0700001096,10310828
MN,54944591.84951174,1920,0,26537,1020731.0700001096,10337365
MN,54944591.84951174,1921,0,13399,1020731.0700001096,10350764
MN,54944591.84951174,1922,0,10839,1020731.0700001096,10361603
MN,54944591.84951174,1923,0,5283,1020731.0700001096,10366886
MN,54944591.84951174,1924,0,5286,1020731.0700001096,10372172
MN,54944591.84951174,1925,0,5508,1020731.0700001096,10377680
MN,54944591.84951174,1926,0,2205,1020731.0700001096,10379885
MN,54944591.84951174,1927,0,1700,1020731.0700001096,10381585
MN,54944591.84951174,1928,0,1724,1020731.0700001096,10383309
MN,54944591.84951174,1929,0,1373,1020731.0700001096,10384682
MN,54944591.84951174,1930,0,840,1020731.0700001096,10385522
MO,44643614.482677914,1862,0,0,0,0
MO,44643614.482677914,1863,0,0,0,0
MO,44643614.482677914,1864,0,0,0,0
MO,44643614.482677914,1865,0,0,0,0
MO,44643614.482677914,1866,0,0,0,0
MO,44643614.482677914,1867,96909.97,0,96909.97,0
MO,44643614.482677914,1868,57338.429999999986,0,154248.4,0
MO,44643614.482677914,1869,13675.1,1974,167923.5,1974
MO,44643614.482677914,1870,0,13744,167923.5,15718
MO,44643614.482677914,1871,5355.41,65490,173278.91,81208
MO,44643614.482677914,1872,2792.24,66988,176071.15,148196
MO,44643614.482677914,1873,629.6,127329,176700.75,275525
MO,44643614.482677914,1874,1280,95005,177980.75,370530
MO,44643614.482677914,1875,2456.43,148568,180437.18,519098
MO,44643614.482677914,1876,640,128690,181077.18,647788
MO,44643614.482677914,1877,1047.6599999999999,135142,182124.84,782930
MO,44643614.482677914,1878,320.65,104944,182445.49,887874
MO,44643614.482677914,1879,640,47673,183085.49,935547
MO,44643614.482677914,1880,358.45,39503,183443.94,975050
MO,44643614.482677914,1881,400,25227,183843.94,1000277
MO,44643614.482677914,1882,1932.25,30523,185776.19,1030800
MO,44643614.482677914,1883,640,34857,186416.19,1065657
MO,44643614.482677914,1884,4880,36515,191296.19,1102172
MO,44643614.482677914,1885,1382.62,40794,192678.81,1142966
MO,44643614.482677914,1886,160,46630,192838.81,1189596
MO,44643614.482677914,1887,0,75022,192838.81,1264618
MO,44643614.482677914,1888,735.34,85329,193574.15,1349947
MO,44643614.482677914,1889,0,120352,193574.15,1470299
MO,44643614.482677914,1890,1524.28,167750,195098.43,1638049
MO,44643614.482677914,1891,1172.8899999999999,183735,196271.32,1821784
MO,44643614.482677914,1892,2293.2,143596,198564.52000000002,1965380
MO,44643614.482677914,1893,586.68,128183,199151.2,2093563
MO,44643614.482677914,1894,0,110304,199151.2,2203867
MO,44643614.482677914,1895,1704.21,98098,200855.41,2301965
MO,44643614.482677914,1896,405.08000000000004,99554,201260.49,2401519
MO,44643614.482677914,1897,724.12,96836,201984.61,2498355
MO,44643614.482677914,1898,0,106360,201984.61,2604715
MO,44643614.482677914,1899,320.22,104015,202304.83,2708730
MO,44643614.482677914,1900,1040.66,137343,203345.49,2846073
MO,44643614.482677914,1901,7130.84,113822,210476.33,2959895
MO,44643614.482677914,1902,840,102543,211316.33,3062438
MO,44643614.482677914,1903,305.78,103057,211622.11,3165495
MO,44643614.482677914,1904,400,78727,212022.11,3244222
MO,44643614.482677914,1905,2409.84,49279,214431.94999999998,3293501
MO,44643614.482677914,1906,358.44,48236,214790.38999999998,3341737
MO,44643614.482677914,1907,845.78,40679,215636.16999999998,3382416
MO,44643614.482677914,1908,1780.4300000100002,36146,217416.60000001,3418562
MO,44643614.482677914,1909,160,38406,217576.60000001,3456968
MO,44643614.482677914,1910,619.25,39881,218195.85000001,3496849
MO,44643614.482677914,1911,200,37233,218395.85000001,3534082
MO,44643614.482677914,1912,160,39001,218555.85000001,3573083
MO,44643614.482677914,1913,0,27154,218555.85000001,3600237
MO,44643614.482677914,1914,266.666666,19148,218822.51666601,3619385
MO,44643614.482677914,1915,0,8614,218822.51666601,3627999
MO,44643614.482677914,1916,0,6764,218822.51666601,3634763
MO,44643614.482677914,1917,320,4371,219142.51666601,3639134
MO,44643614.482677914,1918,0,2070,219142.51666601,3641204
MO,44643614.482677914,1919,0,1381,219142.51666601,3642585
MO,44643614.482677914,1920,0,678,219142.51666601,3643263
MO,44643614.482677914,1921,160.74,723,219303.25666600998,3643986
MO,44643614.482677914,1922,128.79,240,219432.04666601,3644226
MO,44643614.482677914,1923,0,0,219432.04666601,3644226
MO,44643614.482677914,1924,0,0,219432.04666601,3644226
MO,44643614.482677914,1925,0,0,219432.04666601,3644226
MO,44643614.482677914,1926,0,0,219432.04666601,3644226
MO,44643614.482677914,1927,0,0,219432.04666601,3644226
MO,44643614.482677914,1928,0,0,219432.04666601,3644226
MO,44643614.482677914,1929,0,0,219432.04666601,3644226
MO,44643614.482677914,1930,0,0,219432.04666601,3644226
MS,30895962.70696376,1862,0,0,0,0
MS,30895962.70696376,1863,0,0,0,0
MS,30895962.70696376,1864,0,0,0,0
MS,30895962.70696376,1865,0,0,0,0
MS,30895962.70696376,1866,0,0,0,0
MS,30895962.70696376,1867,0,0,0,0
MS,30895962.70696376,1868,0,0,0,0
MS,30895962.70696376,1869,0,0,0,0
MS,30895962.70696376,1870,0,0,0,0
MS,30895962.70696376,1871,80,0,80,0
MS,30895962.70696376,1872,0,539,80,539
MS,30895962.70696376,1873,0,8591,80,9130
MS,30895962.70696376,1874,0,12123,80,21253
MS,30895962.70696376,1875,0,13707,80,34960
MS,30895962.70696376,1876,0,20002,80,54962
MS,30895962.70696376,1877,0,20447,80,75409
MS,30895962.70696376,1878,0,40193,80,115602
MS,30895962.70696376,1879,0,35709,80,151311
MS,30895962.70696376,1880,0,10769,80,162080
MS,30895962.70696376,1881,0,22703,80,184783
MS,30895962.70696376,1882,0,18628,80,203411
MS,30895962.70696376,1883,0,32604,80,236015
MS,30895962.70696376,1884,160.15,34444,240.15,270459
MS,30895962.70696376,1885,0,39203,240.15,309662
MS,30895962.70696376,1886,0,52399,240.15,362061
MS,30895962.70696376,1887,0,70560,240.15,432621
MS,30895962.70696376,1888,0,77098,240.15,509719
MS,30895962.70696376,1889,0,114355,240.15,624074
MS,30895962.70696376,1890,0,35141,240.15,659215
MS,30895962.70696376,1891,0,145436,240.15,804651
MS,30895962.70696376,1892,0,85199,240.15,889850
MS,30895962.70696376,1893,0,71259,240.15,961109
MS,30895962.70696376,1894,0,89871,240.15,1050980
MS,30895962.70696376,1895,0,93656,240.15,1144636
MS,30895962.70696376,1896,0,121685,240.15,1266321
MS,30895962.70696376,1897,0,202058,240.15,1468379
MS,30895962.70696376,1898,0,126712,240.15,1595091
MS,30895962.70696376,1899,334.55999999999995,116707,574.7099999999999,1711798
MS,30895962.70696376,1900,0,75276,574.7099999999999,1787074
MS,30895962.70696376,1901,0,158142,574.7099999999999,1945216
MS,30895962.70696376,1902,0,91639,574.7099999999999,2036855
MS,30895962.70696376,1903,0,47964,574.7099999999999,2084819
MS,30895962.70696376,1904,0,78238,574.7099999999999,2163057
MS,30895962.70696376,1905,157.18,65046,731.8899999999999,2228103
MS,30895962.70696376,1906,712.374,62821,1444.264,2290924
MS,30895962.70696376,1907,285.93600000000004,53250,1730.1999999999998,2344174
MS,30895962.70696376,1908,0,37275,1730.1999999999998,2381449
MS,30895962.70696376,1909,0,30953,1730.1999999999998,2412402
MS,30895962.70696376,1910,0,32743,1730.1999999999998,2445145
MS,30895962.70696376,1911,0,25742,1730.1999999999998,2470887
MS,30895962.70696376,1912,0,26841,1730.1999999999998,2497728
MS,30895962.70696376,1913,0,29236,1730.1999999999998,2526964
MS,30895962.70696376,1914,0,18124,1730.1999999999998,2545088
MS,30895962.70696376,1915,0,11748,1730.1999999999998,2556836
MS,30895962.70696376,1916,0,17435,1730.1999999999998,2574271
MS,30895962.70696376,1917,0,16076,1730.1999999999998,2590347
MS,30895962.70696376,1918,0,14089,1730.1999999999998,2604436
MS,30895962.70696376,1919,0,9218,1730.1999999999998,2613654
MS,30895962.70696376,1920,0,7623,1730.1999999999998,2621277
MS,30895962.70696376,1921,0,3461,1730.1999999999998,2624738
MS,30895962.70696376,1922,0,3617,1730.1999999999998,2628355
MS,30895962.70696376,1923,0,3272,1730.1999999999998,2631627
MS,30895962.70696376,1924,0,2108,1730.1999999999998,2633735
MS,30895962.70696376,1925,0,1464,1730.1999999999998,2635199
MS,30895962.70696376,1926,0,0,1730.1999999999998,2635199
MS,30895962.70696376,1927,0,0,1730.1999999999998,2635199
MS,30895962.70696376,1928,0,0,1730.1999999999998,2635199
MS,30895962.70696376,1929,0,0,1730.1999999999998,2635199
MS,30895962.70696376,1930,0,0,1730.1999999999998,2635199
MT,96047859.24626052,1862,0,0,0,0
MT,96047859.24626052,1863,0,0,0,0
MT,96047859.24626052,1864,0,0,0,0
MT,96047859.24626052,1865,0,0,0,0
MT,96047859.24626052,1866,0,0,0,0
MT,96047859.24626052,1867,0,0,0,0
MT,96047859.24626052,1868,0,0,0,0
MT,96047859.24626052,1869,0,0,0,0
MT,96047859.24626052,1870,0,0,0,0
MT,96047859.24626052,1871,5793.63,0,5793.63,0
MT,96047859.24626052,1872,28532.60999999,0,34326.23999999,0
MT,96047859.24626052,1873,16061.305000010001,154,50387.545,154
MT,96047859.24626052,1874,10727.560000000003,480,61115.105,634
MT,96047859.24626052,1875,4525.539999999999,8482,65640.645,9116
MT,96047859.24626052,1876,17269.578333329995,21806,82910.22333333,30922
MT,96047859.24626052,1877,8785.066666659997,23324,91695.28999999,54246
MT,96047859.24626052,1878,1839.5500000000002,19345,93534.83999999,73591
MT,96047859.24626052,1879,2159.85,10515,95694.68999999,84106
MT,96047859.24626052,1880,1040,4441,96734.68999999,88547
MT,96047859.24626052,1881,800,5646,97534.68999999,94193
MT,96047859.24626052,1882,160,8510,97694.68999999,102703
MT,96047859.24626052,1883,0,18028,97694.68999999,120731
MT,96047859.24626052,1884,160,18527,97854.68999999,139258
MT,96047859.24626052,1885,0,18658,97854.68999999,157916
MT,96047859.24626052,1886,0,30613,97854.68999999,188529
MT,96047859.24626052,1887,0,32513,97854.68999999,221042
MT,96047859.24626052,1888,0,45933,97854.68999999,266975
MT,96047859.24626052,1889,0,54901,97854.68999999,321876
MT,96047859.24626052,1890,0,53692,97854.68999999,375568
MT,96047859.24626052,1891,0,53627,97854.68999999,429195
MT,96047859.24626052,1892,0,60110,97854.68999999,489305
MT,96047859.24626052,1893,0,52251,97854.68999999,541556
MT,96047859.24626052,1894,30085.684927680002,46890,127940.37492767001,588446
MT,96047859.24626052,1895,25254.33282637,59088,153194.70775404002,647534
MT,96047859.24626052,1896,5240,68602,158434.70775404002,716136
MT,96047859.24626052,1897,40,95523,158474.70775404002,811659
MT,96047859.24626052,1898,0,132637,158474.70775404002,944296
MT,96047859.24626052,1899,8111.93,129818,166586.63775404,1074114
MT,96047859.24626052,1900,160,126141,166746.63775404,1200255
MT,96047859.24626052,1901,29227.81,162419,195974.44775404,1362674
MT,96047859.24626052,1902,80,140590,196054.44775404,1503264
MT,96047859.24626052,1903,4727.34,157061,200781.78775404,1660325
MT,96047859.24626052,1904,120,141979,200901.78775404,1802304
MT,96047859.24626052,1905,0,199426,200901.78775404,2001730
MT,96047859.24626052,1906,2511.23,191941,203413.01775404002,2193671
MT,96047859.24626052,1907,200,238459,203613.01775404002,2432130
MT,96047859.24626052,1908,200,218217,203813.01775404002,2650347
MT,96047859.24626052,1909,1640,243388,205453.01775404002,2893735
MT,96047859.24626052,1910,0,277716,205453.01775404002,3171451
MT,96047859.24626052,1911,0,427982,205453.01775404002,3599433
MT,96047859.24626052,1912,0,504171,205453.01775404002,4103604
MT,96047859.24626052,1913,0,1327911,205453.01775404002,5431515
MT,96047859.24626052,1914,1480,2523964,206933.01775404002,7955479
MT,96047859.24626052,1915,510.16,2198135,207443.17775404002,10153614
MT,96047859.24626052,1916,0,2308311,207443.17775404002,12461925
MT,96047859.24626052,1917,0,3180706,207443.17775404002,15642631
MT,96047859.24626052,1918,0,3191706,207443.17775404002,18834337
MT,96047859.24626052,1919,160,2005155,207603.17775404002,20839492
MT,96047859.24626052,1920,480,2260337,208083.17775404002,23099829
MT,96047859.24626052,1921,0,1999042,208083.17775404002,25098871
MT,96047859.24626052,1922,0,1443686,208083.17775404002,26542557
MT,96047859.24626052,1923,0,1017776,208083.17775404002,27560333
MT,96047859.24626052,1924,0,697616,208083.17775404002,28257949
MT,96047859.24626052,1925,200,593292,208283.17775404002,28851241
MT,96047859.24626052,1926,0,533707,208283.17775404002,29384948
MT,96047859.24626052,1927,0,442804,208283.17775404002,29827752
MT,96047859.24626052,1928,0,274567,208283.17775404002,30102319
MT,96047859.24626052,1929,0,250314,208283.17775404002,30352633
MT,96047859.24626052,1930,0,192436,208283.17775404002,30545069
NC,31902563.645036537,1862,0,0,0,0
NC,31902563.645036537,1863,0,0,0,0
NC,31902563.645036537,1864,0,0,0,0
NC,31902563.645036537,1865,0,0,0,0
NC,31902563.645036537,1866,0,0,0,0
NC,31902563.645036537,1867,0,0,0,0
NC,31902563.645036537,1868,0,0,0,0
NC,31902563.645036537,1869,0,0,0,0
NC,31902563.645036537,1870,0,0,0,0
NC,31902563.645036537,1871,0,0,0,0
NC,31902563.645036537,1872,0,0,0,0
NC,31902563.645036537,1873,0,0,0,0
NC,31902563.645036537,1874,0,0,0,0
NC,31902563.645036537,1875,0,0,0,0
NC,31902563.645036537,1876,0,0,0,0
NC,31902563.645036537,1877,0,0,0,0
NC,31902563.645036537,1878,0,0,0,0
NC,31902563.645036537,1879,0,0,0,0
NC,31902563.645036537,1880,0,0,0,0
NC,31902563.645036537,1881,0,0,0,0
NC,31902563.645036537,1882,0,0,0,0
NC,31902563.645036537,1883,0,0,0,0
NC,31902563.645036537,1884,0,0,0,0
NC,31902563.645036537,1885,0,0,0,0
NC,31902563.645036537,1886,0,0,0,0
NC,31902563.645036537,1887,0,0,0,0
NC,31902563.645036537,1888,0,0,0,0
NC,31902563.645036537,1889,0,0,0,0
NC,31902563.645036537,1890,0,0,0,0
NC,31902563.645036537,1891,0,0,0,0
NC,31902563.645036537,1892,0,0,0,0
NC,31902563.645036537,1893,0,0,0,0
NC,31902563.645036537,1894,0,0,0,0
NC,31902563.645036537,1895,0,0,0,0
NC,31902563.645036537,1896,0,0,0,0
NC,31902563.645036537,1897,0,0,0,0
NC,31902563.645036537,1898,0,0,0,0
NC,31902563.645036537,1899,0,0,0,0
NC,31902563.645036537,1900,0,0,0,0
NC,31902563.645036537,1901,0,0,0,0
NC,31902563.645036537,1902,0,0,0,0
NC,31902563.645036537,1903,0,0,0,0
NC,31902563.645036537,1904,0,0,0,0
NC,31902563.645036537,1905,0,0,0,0
NC,31902563.645036537,1906,0,0,0,0
NC,31902563.645036537,1907,0,0,0,0
NC,31902563.645036537,1908,0,0,0,0
NC,31902563.645036537,1909,0,0,0,0
NC,31902563.645036537,1910,0,0,0,0
NC,31902563.645036537,1911,0,0,0,0
NC,31902563.645036537,1912,0,0,0,0
NC,31902563.645036537,1913,0,0,0,0
NC,31902563.645036537,1914,0,0,0,0
NC,31902563.645036537,1915,0,0,0,0
NC,31902563.645036537,1916,0,0,0,0
NC,31902563.645036537,1917,0,0,0,0
NC,31902563.645036537,1918,0,0,0,0
NC,31902563.645036537,1919,0,0,0,0
NC,31902563.645036537,1920,0,0,0,0
NC,31902563.645036537,1921,0,0,0,0
NC,31902563.645036537,1922,0,0,0,0
NC,31902563.645036537,1923,0,0,0,0
NC,31902563.645036537,1924,0,0,0,0
NC,31902563.645036537,1925,0,0,0,0
NC,31902563.645036537,1926,0,0,0,0
NC,31902563.645036537,1927,0,0,0,0
NC,31902563.645036537,1928,0,0,0,0
NC,31902563.645036537,1929,0,0,0,0
NC,31902563.645036537,1930,0,0,0,0
ND,46273168.72736301,1862,0,0,0,0
ND,46273168.72736301,1863,0,0,0,0
ND,46273168.72736301,1864,0,0,0,0
ND,46273168.72736301,1865,0,0,0,0
ND,46273168.72736301,1866,0,0,0,0
ND,46273168.72736301,1867,0,0,0,0
ND,46273168.72736301,1868,0,2301,0,2301
ND,46273168.72736301,1869,0,2196,0,4497
ND,46273168.72736301,1870,0,1600,0,6097
ND,46273168.72736301,1871,0,2599.5,0,8696.5
ND,46273168.72736301,1872,480,5724,480,14420.5
ND,46273168.72736301,1873,0,13604,480,28024.5
ND,46273168.72736301,1874,0,27163,480,55187.5
ND,46273168.72736301,1875,0,31171,480,86358.5
ND,46273168.72736301,1876,0,45461.5,480,131820
ND,46273168.72736301,1877,0,44002,480,175822
ND,46273168.72736301,1878,0,61076.5,480,236898.5
ND,46273168.72736301,1879,0,81499.5,480,318398
ND,46273168.72736301,1880,0,79825,480,398223
ND,46273168.72736301,1881,0,67864.5,480,466087.5
ND,46273168.72736301,1882,320,105043.5,800,571131
ND,46273168.72736301,1883,0,132421.5,800,703552.5
ND,46273168.72736301,1884,0,198908.5,800,902461
ND,46273168.72736301,1885,0,274015.5,800,1176476.5
ND,46273168.72736301,1886,160,244815.5,960,1421292
ND,46273168.72736301,1887,0,303502.5,960,1724794.5
ND,46273168.72736301,1888,479.18,438998,1439.18,2163792.5
ND,46273168.72736301,1889,0,458380,1439.18,2622172.5
ND,46273168.72736301,1890,915.02666666,292754,2354.2066666600003,2914926.5
ND,46273168.72736301,1891,80,240525,2434.2066666600003,3155451.5
ND,46273168.72736301,1892,0,199539,2434.2066666600003,3354990.5
ND,46273168.72736301,1893,318.47,227311,2752.6766666600006,3582301.5
ND,46273168.72736301,1894,59812.879999990015,168906,62565.556666650016,3751207.5
ND,46273168.72736301,1895,40754.44,162728,103319.99666665003,3913935.5
ND,46273168.72736301,1896,25880,137286,129199.99666665003,4051221.5
ND,46273168.72736301,1897,3358.7799999999997,128385,132558.77666665002,4179606.5
ND,46273168.72736301,1898,320,247634,132878.77666665002,4427240.5
ND,46273168.72736301,1899,359.62333333,298645,133238.39999998003,4725885.5
ND,46273168.72736301,1900,120,327838,133358.39999998003,5053723.5
ND,46273168.72736301,1901,0,364779,133358.39999998003,5418502.5
ND,46273168.72736301,1902,0,348178,133358.39999998003,5766680.5
ND,46273168.72736301,1903,0,530448,133358.39999998003,6297128.5
ND,46273168.72736301,1904,0,546242,133358.39999998003,6843370.5
ND,46273168.72736301,1905,755.36,1096719,134113.75999998001,7940089.5
ND,46273168.72736301,1906,27.77,1009103,134141.52999998,8949192.5
ND,46273168.72736301,1907,80,1252474,134221.52999998,10201666.5
ND,46273168.72736301,1908,0,1868088,134221.52999998,12069754.5
ND,46273168.72736301,1909,392.57,1277637,134614.09999998,13347391.5
ND,46273168.72736301,1910,0,954002,134614.09999998,14301393.5
ND,46273168.72736301,1911,0,1047646,134614.09999998,15349039.5
ND,46273168.72736301,1912,154.75,1030959,134768.84999998,16379998.5
ND,46273168.72736301,1913,0,930938,134768.84999998,17310936.5
ND,46273168.72736301,1914,0,594674,134768.84999998,17905610.5
ND,46273168.72736301,1915,0,427212,134768.84999998,18332822.5
ND,46273168.72736301,1916,160,333429,134928.84999998,18666251.5
ND,46273168.72736301,1917,0,324779,134928.84999998,18991030.5
ND,46273168.72736301,1918,0,269096,134928.84999998,19260126.5
ND,46273168.72736301,1919,0,165896,134928.84999998,19426022.5
ND,46273168.72736301,1920,0,202908,134928.84999998,19628930.5
ND,46273168.72736301,1921,0,108807,134928.84999998,19737737.5
ND,46273168.72736301,1922,0,90451,134928.84999998,19828188.5
ND,46273168.72736301,1923,0,51559,134928.84999998,19879747.5
ND,46273168.72736301,1924,0,39127,134928.84999998,19918874.5
ND,46273168.72736301,1925,0,19209,134928.84999998,19938083.5
ND,46273168.72736301,1926,0,17081,134928.84999998,19955164.5
ND,46273168.72736301,1927,0,9545,134928.84999998,19964709.5
ND,46273168.72736301,1928,0,10541,134928.84999998,19975250.5
ND,46273168.72736301,1929,16.9,6535,134945.74999998,19981785.5
ND,46273168.72736301,1930,0,4239,134945.74999998,19986024.5
NE,49606624.299348086,1862,0,0,0,0
NE,49606624.299348086,1863,0,0,0,0
NE,49606624.299348086,1864,0,0,0,0
NE,49606624.299348086,1865,0,0,0,0
NE,49606624.299348086,1866,30906.610000000004,0,30906.610000000004,0
NE,49606624.299348086,1867,89383.62999999999,0,120290.23999999999,0
NE,49606624.299348086,1868,432990.20000000007,20536,553280.4400000001,20536
NE,49606624.299348086,1869,297228.55000000005,41688,850508.9900000001,62224
NE,49606624.299348086,1870,126679.84,42134,977188.8300000001,104358
NE,49606624.299348086,1871,5267.469999999999,61466,982456.3,165824
NE,49606624.299348086,1872,40577.630000000005,91447,1023033.93,257271
NE,49606624.299348086,1873,120191.77333330999,220421,1143225.70333331,477692
NE,49606624.299348086,1874,34705.74666665998,321744,1177931.4499999702,799436
NE,49606624.299348086,1875,16439.619999990005,344346,1194371.0699999603,1143782
NE,49606624.299348086,1876,4606.24,418962,1198977.3099999602,1562744
NE,49606624.299348086,1877,4377.45000001,422148,1203354.7599999702,1984892
NE,49606624.299348086,1878,800,456076,1204154.7599999702,2440968
NE,49606624.299348086,1879,321.40000001,349373,1204476.1599999801,2790341
NE,49606624.299348086,1880,320.64,315501,1204796.79999998,3105842
NE,49606624.299348086,1881,880,202242,1205676.79999998,3308084
NE,49606624.299348086,1882,1735.37,258393,1207412.1699999801,3566477
NE,49606624.299348086,1883,0,241512,1207412.1699999801,3807989
NE,49606624.299348086,1884,160,375129,1207572.1699999801,4183118
NE,49606624.299348086,1885,0,393240,1207572.1699999801,4576358
NE,49606624.299348086,1886,0,328969,1207572.1699999801,4905327
NE,49606624.299348086,1887,0,292875,1207572.1699999801,5198202
NE,49606624.299348086,1888,480,331409,1208052.1699999801,5529611
NE,49606624.299348086,1889,960,467373,1209012.1699999801,5996984
NE,49606624.299348086,1890,2483.68,651732,1211495.84999998,6648716
NE,49606624.299348086,1891,4144.639999999999,611117,1215640.48999998,7259833
NE,49606624.299348086,1892,640,431591,1216280.48999998,7691424
NE,49606624.299348086,1893,0,451773,1216280.48999998,8143197
NE,49606624.299348086,1894,0,342155,1216280.48999998,8485352
NE,49606624.299348086,1895,0,255846,1216280.48999998,8741198
NE,49606624.299348086,1896,320,185246,1216600.48999998,8926444
NE,49606624.299348086,1897,320,153094,1216920.48999998,9079538
NE,49606624.299348086,1898,0,181247,1216920.48999998,9260785
NE,49606624.299348086,1899,320,178093,1217240.48999998,9438878
NE,49606624.299348086,1900,0,191580,1217240.48999998,9630458
NE,49606624.299348086,1901,0,213550,1217240.48999998,9844008
NE,49606624.299348086,1902,0,151043,1217240.48999998,9995051
NE,49606624.299348086,1903,160,119993,1217400.48999998,10115044
NE,49606624.299348086,1904,640,120783,1218040.48999998,10235827
NE,49606624.299348086,1905,595.84,147956,1218636.32999998,10383783
NE,49606624.299348086,1906,0,139562,1218636.32999998,10523345
NE,49606624.299348086,1907,320,161146,1218956.32999998,10684491
NE,49606624.299348086,1908,0,183938,1218956.32999998,10868429
NE,49606624.299348086,1909,0,163739,1218956.32999998,11032168
NE,49606624.299348086,1910,1120,960735,1220076.32999998,11992903
NE,49606624.299348086,1911,918.64,1332060,1220994.96999998,13324963
NE,49606624.299348086,1912,0,1039054,1220994.96999998,14364017
NE,49606624.299348086,1913,640,2476575,1221634.96999998,16840592
NE,49606624.299348086,1914,160,1393136,1221794.96999998,18233728
NE,49606624.299348086,1915,320,1081093,1222114.96999998,19314821
NE,49606624.299348086,1916,0,1079043,1222114.96999998,20393864
NE,49606624.299348086,1917,0,791546,1222114.96999998,21185410
NE,49606624.299348086,1918,320,417889,1222434.96999998,21603299
NE,49606624.299348086,1919,457.61,208776,1222892.57999998,21812075
NE,49606624.299348086,1920,0,139968,1222892.57999998,21952043
NE,49606624.299348086,1921,0,72240,1222892.57999998,22024283
NE,49606624.299348086,1922,0,49648,1222892.57999998,22073931
NE,49606624.299348086,1923,0,36064,1222892.57999998,22109995
NE,49606624.299348086,1924,0,29067,1222892.57999998,22139062
NE,49606624.299348086,1925,0,14246,1222892.57999998,22153308
NE,49606624.299348086,1926,0,14443,1222892.57999998,22167751
NE,49606624.299348086,1927,0,13194,1222892.57999998,22180945
NE,49606624.299348086,1928,0,13077,1222892.57999998,22194022
NE,49606624.299348086,1929,0,6708,1222892.57999998,22200730
NE,49606624.299348086,1930,0,13417,1222892.57999998,22214147
NH,5979966.077386408,1862,0,0,0,0
NH,5979966.077386408,1863,0,0,0,0
NH,5979966.077386408,1864,0,0,0,0
NH,5979966.077386408,1865,0,0,0,0
NH,5979966.077386408,1866,0,0,0,0
NH,5979966.077386408,1867,0,0,0,0
NH,5979966.077386408,1868,0,0,0,0
NH,5979966.077386408,1869,0,0,0,0
NH,5979966.077386408,1870,0,0,0,0
NH,5979966.077386408,1871,0,0,0,0
NH,5979966.077386408,1872,0,0,0,0
NH,5979966.077386408,1873,0,0,0,0
NH,5979966.077386408,1874,0,0,0,0
NH,5979966.077386408,1875,0,0,0,0
NH,5979966.077386408,1876,0,0,0,0
NH,5979966.077386408,1877,0,0,0,0
NH,5979966.077386408,1878,0,0,0,0
NH,5979966.077386408,1879,0,0,0,0
NH,5979966.077386408,1880,0,0,0,0
NH,5979966.077386408,1881,0,0,0,0
NH,5979966.077386408,1882,0,0,0,0
NH,5979966.077386408,1883,0,0,0,0
NH,5979966.077386408,1884,0,0,0,0
NH,5979966.077386408,1885,0,0,0,0
NH,5979966.077386408,1886,0,0,0,0
NH,5979966.077386408,1887,0,0,0,0
NH,5979966.077386408,1888,0,0,0,0
NH,5979966.077386408,1889,0,0,0,0
NH,5979966.077386408,1890,0,0,0,0
NH,5979966.077386408,1891,0,0,0,0
NH,5979966.077386408,1892,0,0,0,0
NH,5979966.077386408,1893,0,0,0,0
NH,5979966.077386408,1894,0,0,0,0
NH,5979966.077386408,1895,0,0,0,0
NH,5979966.077386408,1896,0,0,0,0
NH,5979966.077386408,1897,0,0,0,0
NH,5979966.077386408,1898,0,0,0,0
NH,5979966.077386408,1899,0,0,0,0
NH,5979966.077386408,1900,0,0,0,0
NH,5979966.077386408,1901,0,0,0,0
NH,5979966.077386408,1902,0,0,0,0
NH,5979966.077386408,1903,0,0,0,0
NH,5979966.077386408,1904,0,0,0,0
NH,5979966.077386408,1905,0,0,0,0
NH,5979966.077386408,1906,0,0,0,0
NH,5979966.077386408,1907,0,0,0,0
NH,5979966.077386408,1908,0,0,0,0
NH,5979966.077386408,1909,0,0,0,0
NH,5979966.077386408,1910,0,0,0,0
NH,5979966.077386408,1911,0,0,0,0
NH,5979966.077386408,1912,0,0,0,0
NH,5979966.077386408,1913,0,0,0,0
NH,5979966.077386408,1914,0,0,0,0
NH,5979966.077386408,1915,0,0,0,0
NH,5979966.077386408,1916,0,0,0,0
NH,5979966.077386408,1917,0,0,0,0
NH,5979966.077386408,1918,0,0,0,0
NH,5979966.077386408,1919,0,0,0,0
NH,5979966.077386408,1920,0,0,0,0
NH,5979966.077386408,1921,0,0,0,0
NH,5979966.077386408,1922,0,0,0,0
NH,5979966.077386408,1923,0,0,0,0
NH,5979966.077386408,1924,0,0,0,0
NH,5979966.077386408,1925,0,0,0,0
NH,5979966.077386408,1926,0,0,0,0
NH,5979966.077386408,1927,0,0,0,0
NH,5979966.077386408,1928,0,0,0,0
NH,5979966.077386408,1929,0,0,0,0
NH,5979966.077386408,1930,0,0,0,0
NJ,4977576.2004558295,1862,0,0,0,0
NJ,4977576.2004558295,1863,0,0,0,0
NJ,4977576.2004558295,1864,0,0,0,0
NJ,4977576.2004558295,1865,0,0,0,0
NJ,4977576.2004558295,1866,0,0,0,0
NJ,4977576.2004558295,1867,0,0,0,0
NJ,4977576.2004558295,1868,0,0,0,0
NJ,4977576.2004558295,1869,0,0,0,0
NJ,4977576.2004558295,1870,0,0,0,0
NJ,4977576.2004558295,1871,0,0,0,0
NJ,4977576.2004558295,1872,0,0,0,0
NJ,4977576.2004558295,1873,0,0,0,0
NJ,4977576.2004558295,1874,0,0,0,0
NJ,4977576.2004558295,1875,0,0,0,0
NJ,4977576.2004558295,1876,0,0,0,0
NJ,4977576.2004558295,1877,0,0,0,0
NJ,4977576.2004558295,1878,0,0,0,0
NJ,4977576.2004558295,1879,0,0,0,0
NJ,4977576.2004558295,1880,0,0,0,0
NJ,4977576.2004558295,1881,0,0,0,0
NJ,4977576.2004558295,1882,0,0,0,0
NJ,4977576.2004558295,1883,0,0,0,0
NJ,4977576.2004558295,1884,0,0,0,0
NJ,4977576.2004558295,1885,0,0,0,0
NJ,4977576.2004558295,1886,0,0,0,0
NJ,4977576.2004558295,1887,0,0,0,0
NJ,4977576.2004558295,1888,0,0,0,0
NJ,4977576.2004558295,1889,0,0,0,0
NJ,4977576.2004558295,1890,0,0,0,0
NJ,4977576.2004558295,1891,0,0,0,0
NJ,4977576.2004558295,1892,0,0,0,0
NJ,4977576.2004558295,1893,0,0,0,0
NJ,4977576.2004558295,1894,0,0,0,0
NJ,4977576.2004558295,1895,0,0,0,0
NJ,4977576.2004558295,1896,0,0,0,0
NJ,4977576.2004558295,1897,0,0,0,0
NJ,4977576.2004558295,1898,0,0,0,0
NJ,4977576.2004558295,1899,0,0,0,0
NJ,4977576.2004558295,1900,0,0,0,0
NJ,4977576.2004558295,1901,0,0,0,0
NJ,4977576.2004558295,1902,0,0,0,0
NJ,4977576.2004558295,1903,0,0,0,0
NJ,4977576.2004558295,1904,0,0,0,0
NJ,4977576.2004558295,1905,0,0,0,0
NJ,4977576.2004558295,1906,0,0,0,0
NJ,4977576.2004558295,1907,0,0,0,0
NJ,4977576.2004558295,1908,0,0,0,0
NJ,4977576.2004558295,1909,0,0,0,0
NJ,4977576.2004558295,1910,0,0,0,0
NJ,4977576.2004558295,1911,0,0,0,0
NJ,4977576.2004558295,1912,0,0,0,0
NJ,4977576.2004558295,1913,0,0,0,0
NJ,4977576.2004558295,1914,0,0,0,0
NJ,4977576.2004558295,1915,0,0,0,0
NJ,4977576.2004558295,1916,0,0,0,0
NJ,4977576.2004558295,1917,0,0,0,0
NJ,4977576.2004558295,1918,0,0,0,0
NJ,4977576.2004558295,1919,0,0,0,0
NJ,4977576.2004558295,1920,0,0,0,0
NJ,4977576.2004558295,1921,0,0,0,0
NJ,4977576.2004558295,1922,0,0,0,0
NJ,4977576.2004558295,1923,0,0,0,0
NJ,4977576.2004558295,1924,0,0,0,0
NJ,4977576.2004558295,1925,0,0,0,0
NJ,4977576.2004558295,1926,0,0,0,0
NJ,4977576.2004558295,1927,0,0,0,0
NJ,4977576.2004558295,1928,0,0,0,0
NJ,4977576.2004558295,1929,0,0,0,0
NJ,4977576.2004558295,1930,0,0,0,0
NM,78387363.33292463,1862,0,0,0,0
NM,78387363.33292463,1863,0,0,0,0
NM,78387363.33292463,1864,0,0,0,0
NM,78387363.33292463,1865,0,0,0,0
NM,78387363.33292463,1866,0,0,0,0
NM,78387363.33292463,1867,0,0,0,0
NM,78387363.33292463,1868,0,0,0,0
NM,78387363.33292463,1869,0,0,0,0
NM,78387363.33292463,1870,0,0,0,0
NM,78387363.33292463,1871,0,0,0,0
NM,78387363.33292463,1872,0,0,0,0
NM,78387363.33292463,1873,0,640,0,640
NM,78387363.33292463,1874,0,160,0,800
NM,78387363.33292463,1875,960,1284,960,2084
NM,78387363.33292463,1876,160,5541,1120,7625
NM,78387363.33292463,1877,0,1040,1120,8665
NM,78387363.33292463,1878,0,1159,1120,9824
NM,78387363.33292463,1879,160,1259,1280,11083
NM,78387363.33292463,1880,160,2000,1440,13083
NM,78387363.33292463,1881,0,38602,1440,51685
NM,78387363.33292463,1882,960,37166,2400,88851
NM,78387363.33292463,1883,320,81487,2720,170338
NM,78387363.33292463,1884,0,40215,2720,210553
NM,78387363.33292463,1885,0,27754,2720,238307
NM,78387363.33292463,1886,0,23143,2720,261450
NM,78387363.33292463,1887,0,15120,2720,276570
NM,78387363.33292463,1888,240.57,20758,2960.57,297328
NM,78387363.33292463,1889,80.5,19876,3041.07,317204
NM,78387363.33292463,1890,0,21573,3041.07,338777
NM,78387363.33292463,1891,160,36494,3201.07,375271
NM,78387363.33292463,1892,0,33438,3201.07,408709
NM,78387363.33292463,1893,0,53215,3201.07,461924
NM,78387363.33292463,1894,84.50666666,37210,3285.5766666600002,499134
NM,78387363.33292463,1895,82.25333333,30671,3367.82999999,529805
NM,78387363.33292463,1896,0,31474,3367.82999999,561279
NM,78387363.33292463,1897,0,41686,3367.82999999,602965
NM,78387363.33292463,1898,60539.91357144,56274,63907.74357143,659239
NM,78387363.33292463,1899,3680,52048,67587.74357143001,711287
NM,78387363.33292463,1900,0,45929,67587.74357143001,757216
NM,78387363.33292463,1901,27211.93000001,58789,94799.67357144001,816005
NM,78387363.33292463,1902,3840.37,55580,98640.04357144001,871585
NM,78387363.33292463,1903,17301.170000010003,67633,115941.21357145,939218
NM,78387363.33292463,1904,9974.199999999997,79850,125915.41357145,1019068
NM,78387363.33292463,1905,1937.45,128034,127852.86357145,1147102
NM,78387363.33292463,1906,160,157108,128012.86357145,1304210
NM,78387363.33292463,1907,320,206306,128332.86357145,1510516
NM,78387363.33292463,1908,750.815,394928,129083.67857145,1905444
NM,78387363.33292463,1909,119.72999999999999,565321,129203.40857145,2470765
NM,78387363.33292463,1910,204.305,495793,129407.71357144999,2966558
NM,78387363.33292463,1911,80,465527,129487.71357144999,3432085
NM,78387363.33292463,1912,0,495271,129487.71357144999,3927356
NM,78387363.33292463,1913,16534.93,1368393,146022.64357145,5295749
NM,78387363.33292463,1914,37737.198,1237489,183759.84157145,6533238
NM,78387363.33292463,1915,15807.679999999997,627298,199567.52157145,7160536
NM,78387363.33292463,1916,8952.690999999999,589888,208520.21257144999,7750424
NM,78387363.33292463,1917,800,562912,209320.21257144999,8313336
NM,78387363.33292463,1918,10555.02,620616,219875.23257144997,8933952
NM,78387363.33292463,1919,400,633853,220275.23257144997,9567805
NM,78387363.33292463,1920,360,935876,220635.23257144997,10503681
NM,78387363.33292463,1921,39.73,917654,220674.96257144999,11421335
NM,78387363.33292463,1922,332.54,938333,221007.50257145,12359668
NM,78387363.33292463,1923,1965.5,708175,222973.00257145,13067843
NM,78387363.33292463,1924,0,707029,222973.00257145,13774872
NM,78387363.33292463,1925,2829.3,567488,225802.30257144998,14342360
NM,78387363.33292463,1926,0,528436,225802.30257144998,14870796
NM,78387363.33292463,1927,0,447739,225802.30257144998,15318535
NM,78387363.33292463,1928,0,279996,225802.30257144998,15598531
NM,78387363.33292463,1929,0,337144,225802.30257144998,15935675
NM,78387363.33292463,1930,1718.42,204416,227520.72257145,16140091
NV,70828622.68166265,1862,0,0,0,0
NV,70828622.68166265,1863,0,0,0,0
NV,70828622.68166265,1864,0,0,0,0
NV,70828622.68166265,1865,0,0,0,0
NV,70828622.68166265,1866,0,0,0,0
NV,70828622.68166265,1867,0,0,0,0
NV,70828622.68166265,1868,0,0,0,0
NV,70828622.68166265,1869,0,0,0,0
NV,70828622.68166265,1870,0,1440,0,1440
NV,70828622.68166265,1871,0,160,0,1600
NV,70828622.68166265,1872,320,440,320,2040
NV,70828622.68166265,1873,835.94,320,1155.94,2360
NV,70828622.68166265,1874,12033.52,0,13189.460000000001,2360
NV,70828622.68166265,1875,17990.55346151,1437,31180.013461510003,3797
NV,70828622.68166265,1876,17414.862905579994,1990,48594.87636708999,5787
NV,70828622.68166265,1877,30980.045882460006,3984,79574.92224955,9771
NV,70828622.68166265,1878,0,4658,79574.92224955,14429
NV,70828622.68166265,1879,0,5203,79574.92224955,19632
NV,70828622.68166265,1880,0,1762,79574.92224955,21394
NV,70828622.68166265,1881,40,3394,79614.92224955,24788
NV,70828622.68166265,1882,1434.6000000000001,3954,81049.52224955,28742
NV,70828622.68166265,1883,0,2751,81049.52224955,31493
NV,70828622.68166265,1884,0,4515,81049.52224955,36008
NV,70828622.68166265,1885,0,3189,81049.52224955,39197
NV,70828622.68166265,1886,0,2999,81049.52224955,42196
NV,70828622.68166265,1887,0,1615,81049.52224955,43811
NV,70828622.68166265,1888,0,1912,81049.52224955,45723
NV,70828622.68166265,1889,0,1830,81049.52224955,47553
NV,70828622.68166265,1890,0,360,81049.52224955,47913
NV,70828622.68166265,1891,38.56,1791,81088.08224955,49704
NV,70828622.68166265,1892,0,677,81088.08224955,50381
NV,70828622.68166265,1893,0,798,81088.08224955,51179
NV,70828622.68166265,1894,0,931,81088.08224955,52110
NV,70828622.68166265,1895,0,160,81088.08224955,52270
NV,70828622.68166265,1896,0,320,81088.08224955,52590
NV,70828622.68166265,1897,0,1410,81088.08224955,54000
NV,70828622.68166265,1898,0,1409,81088.08224955,55409
NV,70828622.68166265,1899,0,1367,81088.08224955,56776
NV,70828622.68166265,1900,0,987,81088.08224955,57763
NV,70828622.68166265,1901,120,1195,81208.08224955,58958
NV,70828622.68166265,1902,748.29666667,1194,81956.37891622,60152
NV,70828622.68166265,1903,560,480,82516.37891622,60632
NV,70828622.68166265,1904,80,316,82596.37891622,60948
NV,70828622.68166265,1905,37.37,1476,82633.74891621999,62424
NV,70828622.68166265,1906,149.32,3467,82783.06891622,65891
NV,70828622.68166265,1907,0,7292,82783.06891622,73183
NV,70828622.68166265,1908,0,6258,82783.06891622,79441
NV,70828622.68166265,1909,0,3883,82783.06891622,83324
NV,70828622.68166265,1910,0,4446,82783.06891622,87770
NV,70828622.68166265,1911,0,6358,82783.06891622,94128
NV,70828622.68166265,1912,0,5745,82783.06891622,99873
NV,70828622.68166265,1913,0,12703,82783.06891622,112576
NV,70828622.68166265,1914,0,16990,82783.06891622,129566
NV,70828622.68166265,1915,0,25999,82783.06891622,155565
NV,70828622.68166265,1916,0,39073,82783.06891622,194638
NV,70828622.68166265,1917,40.24,36509,82823.30891622,231147
NV,70828622.68166265,1918,0,41227,82823.30891622,272374
NV,70828622.68166265,1919,0,23531,82823.30891622,295905
NV,70828622.68166265,1920,0,32872,82823.30891622,328777
NV,70828622.68166265,1921,0,24496,82823.30891622,353273
NV,70828622.68166265,1922,0,27883,82823.30891622,381156
NV,70828622.68166265,1923,0,37531,82823.30891622,418687
NV,70828622.68166265,1924,0,33027,82823.30891622,451714
NV,70828622.68166265,1925,41.150000000000006,30666,82864.45891622,482380
NV,70828622.68166265,1926,0,30148,82864.45891622,512528
NV,70828622.68166265,1927,0,23713,82864.45891622,536241
NV,70828622.68166265,1928,0,24289,82864.45891622,560530
NV,70828622.68166265,1929,40,21062,82904.45891622,581592
NV,70828622.68166265,1930,0,20454,82904.45891622,602046
NY,31532399.51834436,1862,0,0,0,0
NY,31532399.51834436,1863,0,0,0,0
NY,31532399.51834436,1864,0,0,0,0
NY,31532399.51834436,1865,0,0,0,0
NY,31532399.51834436,1866,0,0,0,0
NY,31532399.51834436,1867,0,0,0,0
NY,31532399.51834436,1868,0,0,0,0
NY,31532399.51834436,1869,0,0,0,0
NY,31532399.51834436,1870,0,0,0,0
NY,31532399.51834436,1871,0,0,0,0
NY,31532399.51834436,1872,0,0,0,0
NY,31532399.51834436,1873,0,0,0,0
NY,31532399.51834436,1874,0,0,0,0
NY,31532399.51834436,1875,0,0,0,0
NY,31532399.51834436,1876,0,0,0,0
NY,31532399.51834436,1877,0,0,0,0
NY,31532399.51834436,1878,0,0,0,0
NY,31532399.51834436,1879,0,0,0,0
NY,31532399.51834436,1880,0,0,0,0
NY,31532399.51834436,1881,0,0,0,0
NY,31532399.51834436,1882,0,0,0,0
NY,31532399.51834436,1883,0,0,0,0
NY,31532399.51834436,1884,0,0,0,0
NY,31532399.51834436,1885,0,0,0,0
NY,31532399.51834436,1886,0,0,0,0
NY,31532399.51834436,1887,0,0,0,0
NY,31532399.51834436,1888,0,0,0,0
NY,31532399.51834436,1889,0,0,0,0
NY,31532399.51834436,1890,0,0,0,0
NY,31532399.51834436,1891,0,0,0,0
NY,31532399.51834436,1892,0,0,0,0
NY,31532399.51834436,1893,0,0,0,0
NY,31532399.51834436,1894,0,0,0,0
NY,31532399.51834436,1895,0,0,0,0
NY,31532399.51834436,1896,0,0,0,0
NY,31532399.51834436,1897,0,0,0,0
NY,31532399.51834436,1898,0,0,0,0
NY,31532399.51834436,1899,0,0,0,0
NY,31532399.51834436,1900,0,0,0,0
NY,31532399.51834436,1901,0,0,0,0
NY,31532399.51834436,1902,0,0,0,0
NY,31532399.51834436,1903,0,0,0,0
NY,31532399.51834436,1904,0,0,0,0
NY,31532399.51834436,1905,0,0,0,0
NY,31532399.51834436,1906,0,0,0,0
NY,31532399.51834436,1907,0,0,0,0
NY,31532399.51834436,1908,0,0,0,0
NY,31532399.51834436,1909,0,0,0,0
NY,31532399.51834436,1910,0,0,0,0
NY,31532399.51834436,1911,0,0,0,0
NY,31532399.51834436,1912,0,0,0,0
NY,31532399.51834436,1913,0,0,0,0
NY,31532399.51834436,1914,0,0,0,0
NY,31532399.51834436,1915,0,0,0,0
NY,31532399.51834436,1916,0,0,0,0
NY,31532399.51834436,1917,0,0,0,0
NY,31532399.51834436,1918,0,0,0,0
NY,31532399.51834436,1919,0,0,0,0
NY,31532399.51834436,1920,0,0,0,0
NY,31532399.51834436,1921,0,0,0,0
NY,31532399.51834436,1922,0,0,0,0
NY,31532399.51834436,1923,0,0,0,0
NY,31532399.51834436,1924,0,0,0,0
NY,31532399.51834436,1925,0,0,0,0
NY,31532399.51834436,1926,0,0,0,0
NY,31532399.51834436,1927,0,0,0,0
NY,31532399.51834436,1928,0,0,0,0
NY,31532399.51834436,1929,0,0,0,0
NY,31532399.51834436,1930,0,0,0,0
OH,26424086.475493707,1862,0,0,0,0
OH,26424086.475493707,1863,0,0,0,0
OH,26424086.475493707,1864,0,0,0,0
OH,26424086.475493707,1865,0,0,0,0
OH,26424086.475493707,1866,0,0,0,0
OH,26424086.475493707,1867,0,0,0,0
OH,26424086.475493707,1868,0,200,0,200
OH,26424086.475493707,1869,0,1107,0,1307
OH,26424086.475493707,1870,0,559,0,1866
OH,26424086.475493707,1871,0,261,0,2127
OH,26424086.475493707,1872,0,256,0,2383
OH,26424086.475493707,1873,0,224,0,2607
OH,26424086.475493707,1874,0,773,0,3380
OH,26424086.475493707,1875,0,1434,0,4814
OH,26424086.475493707,1876,0,1080,0,5894
OH,26424086.475493707,1877,0,838,0,6732
OH,26424086.475493707,1878,0,262,0,6994
OH,26424086.475493707,1879,0,198,0,7192
OH,26424086.475493707,1880,0,120,0,7312
OH,26424086.475493707,1881,0,120,0,7432
OH,26424086.475493707,1882,0,40,0,7472
OH,26424086.475493707,1883,0,160,0,7632
OH,26424086.475493707,1884,0,0,0,7632
OH,26424086.475493707,1885,0,0,0,7632
OH,26424086.475493707,1886,0,40,0,7672
OH,26424086.475493707,1887,0,0,0,7672
OH,26424086.475493707,1888,0,0,0,7672
OH,26424086.475493707,1889,0,0,0,7672
OH,26424086.475493707,1890,0,0,0,7672
OH,26424086.475493707,1891,0,0,0,7672
OH,26424086.475493707,1892,0,0,0,7672
OH,26424086.475493707,1893,0,0,0,7672
OH,26424086.475493707,1894,0,0,0,7672
OH,26424086.475493707,1895,0,0,0,7672
OH,26424086.475493707,1896,0,0,0,7672
OH,26424086.475493707,1897,0,0,0,7672
OH,26424086.475493707,1898,0,0,0,7672
OH,26424086.475493707,1899,0,0,0,7672
OH,26424086.475493707,1900,0,0,0,7672
OH,26424086.475493707,1901,0,0,0,7672
OH,26424086.475493707,1902,0,35,0,7707
OH,26424086.475493707,1903,0,0,0,7707
OH,26424086.475493707,1904,0,0,0,7707
OH,26424086.475493707,1905,0,0,0,7707
OH,26424086.475493707,1906,0,0,0,7707
OH,26424086.475493707,1907,0,0,0,7707
OH,26424086.475493707,1908,0,0,0,7707
OH,26424086.475493707,1909,0,0,0,7707
OH,26424086.475493707,1910,0,0,0,7707
OH,26424086.475493707,1911,0,0,0,7707
OH,26424086.475493707,1912,0,0,0,7707
OH,26424086.475493707,1913,0,0,0,7707
OH,26424086.475493707,1914,0,0,0,7707
OH,26424086.475493707,1915,0,0,0,7707
OH,26424086.475493707,1916,0,0,0,7707
OH,26424086.475493707,1917,0,0,0,7707
OH,26424086.475493707,1918,0,0,0,7707
OH,26424086.475493707,1919,0,0,0,7707
OH,26424086.475493707,1920,0,0,0,7707
OH,26424086.475493707,1921,0,0,0,7707
OH,26424086.475493707,1922,0,0,0,7707
OH,26424086.475493707,1923,0,0,0,7707
OH,26424086.475493707,1924,0,0,0,7707
OH,26424086.475493707,1925,0,0,0,7707
OH,26424086.475493707,1926,0,0,0,7707
OH,26424086.475493707,1927,0,0,0,7707
OH,26424086.475493707,1928,0,0,0,7707
OH,26424086.475493707,1929,0,0,0,7707
OH,26424086.475493707,1930,0,0,0,7707
OK,44915471.700843416,1862,0,0,0,0
OK,44915471.700843416,1863,0,0,0,0
OK,44915471.700843416,1864,0,0,0,0
OK,44915471.700843416,1865,0,0,0,0
OK,44915471.700843416,1866,0,0,0,0
OK,44915471.700843416,1867,0,0,0,0
OK,44915471.700843416,1868,0,0,0,0
OK,44915471.700843416,1869,0,0,0,0
OK,44915471.700843416,1870,0,0,0,0
OK,44915471.700843416,1871,0,0,0,0
OK,44915471.700843416,1872,0,0,0,0
OK,44915471.700843416,1873,0,0,0,0
OK,44915471.700843416,1874,0,0,0,0
OK,44915471.700843416,1875,0,0,0,0
OK,44915471.700843416,1876,0,0,0,0
OK,44915471.700843416,1877,0,0,0,0
OK,44915471.700843416,1878,0,0,0,0
OK,44915471.700843416,1879,0,0,0,0
OK,44915471.700843416,1880,0,0,0,0
OK,44915471.700843416,1881,0,0,0,0
OK,44915471.700843416,1882,0,0,0,0
OK,44915471.700843416,1883,0,0,0,0
OK,44915471.700843416,1884,0,0,0,0
OK,44915471.700843416,1885,0,0,0,0
OK,44915471.700843416,1886,0,0,0,0
OK,44915471.700843416,1887,0,0,0,0
OK,44915471.700843416,1888,0,0,0,0
OK,44915471.700843416,1889,0,0,0,0
OK,44915471.700843416,1890,0,960,0,960
OK,44915471.700843416,1891,0,16200,0,17160
OK,44915471.700843416,1892,0,26568,0,43728
OK,44915471.700843416,1893,0,36420,0,80148
OK,44915471.700843416,1894,0,91638,0,171786
OK,44915471.700843416,1895,0,499384,0,671170
OK,44915471.700843416,1896,0,387217,0,1058387
OK,44915471.700843416,1897,0,224050,0,1282437
OK,44915471.700843416,1898,0,208437,0,1490874
OK,44915471.700843416,1899,0,237939,0,1728813
OK,44915471.700843416,1900,0,392401,0,2121214
OK,44915471.700843416,1901,0,1924630,0,4045844
OK,44915471.700843416,1902,0,1375344,0,5421188
OK,44915471.700843416,1903,0,649761,0,6070949
OK,44915471.700843416,1904,0,626600,0,6697549
OK,44915471.700843416,1905,0,1056590,0,7754139
OK,44915471.700843416,1906,0,1035873,0,8790012
OK,44915471.700843416,1907,0,1202318,0,9992330
OK,44915471.700843416,1908,0,1245974,0,11238304
OK,44915471.700843416,1909,0,1182478,0,12420782
OK,44915471.700843416,1910,0,657485,0,13078267
OK,44915471.700843416,1911,0,553846,0,13632113
OK,44915471.700843416,1912,0,336557,0,13968670
OK,44915471.700843416,1913,0,381229,0,14349899
OK,44915471.700843416,1914,0,168059,0,14517958
OK,44915471.700843416,1915,0,75002,0,14592960
OK,44915471.700843416,1916,0,59875,0,14652835
OK,44915471.700843416,1917,0,50749,0,14703584
OK,44915471.700843416,1918,0,33657,0,14737241
OK,44915471.700843416,1919,0,22834,0,14760075
OK,44915471.700843416,1920,0,29310,0,14789385
OK,44915471.700843416,1921,0,16273,0,14805658
OK,44915471.700843416,1922,0,16643,0,14822301
OK,44915471.700843416,1923,0,10039,0,14832340
OK,44915471.700843416,1924,0,10199,0,14842539
OK,44915471.700843416,1925,0,7921,0,14850460
OK,44915471.700843416,1926,0,7858,0,14858318
OK,44915471.700843416,1927,0,6867,0,14865185
OK,44915471.700843416,1928,0,0,0,14865185
OK,44915471.700843416,1929,0,0,0,14865185
OK,44915471.700843416,1930,0,0,0,14865185
OR,62586967.535441294,1862,0,0,0,0
OR,62586967.535441294,1863,0,0,0,0
OR,62586967.535441294,1864,0,0,0,0
OR,62586967.535441294,1865,0,0,0,0
OR,62586967.535441294,1866,0,0,0,0
OR,62586967.535441294,1867,0,0,0,0
OR,62586967.535441294,1868,160,4068,160,4068
OR,62586967.535441294,1869,13358.919999990001,9529,13518.919999990001,13597
OR,62586967.535441294,1870,5429.66,15371,18948.57999999,28968
OR,62586967.535441294,1871,1440,23499,20388.57999999,52467
OR,62586967.535441294,1872,16788.670000010003,26971,37177.25,79438
OR,62586967.535441294,1873,13017.550000020005,39542,50194.800000020005,118980
OR,62586967.535441294,1874,91685.97999973975,36996,141880.77999975975,155976
OR,62586967.535441294,1875,3060.605,47620,144941.38499975976,203596
OR,62586967.535441294,1876,11759.314999899998,44796,156700.69999965976,248392
OR,62586967.535441294,1877,2840.31,58290,159541.00999965976,306682
OR,62586967.535441294,1878,280,54749,159821.00999965976,361431
OR,62586967.535441294,1879,0,36025,159821.00999965976,397456
OR,62586967.535441294,1880,0,39874,159821.00999965976,437330
OR,62586967.535441294,1881,652.1600000000001,50317,160473.16999965976,487647
OR,62586967.535441294,1882,452.15999999999997,63638,160925.32999965976,551285
OR,62586967.535441294,1883,0,85560,160925.32999965976,636845
OR,62586967.535441294,1884,0,77285,160925.32999965976,714130
OR,62586967.535441294,1885,0,67991,160925.32999965976,782121
OR,62586967.535441294,1886,0,76025,160925.32999965976,858146
OR,62586967.535441294,1887,0,90774,160925.32999965976,948920
OR,62586967.535441294,1888,0,118926,160925.32999965976,1067846
OR,62586967.535441294,1889,160,145765,161085.32999965976,1213611
OR,62586967.535441294,1890,320,140309,161405.32999965976,1353920
OR,62586967.535441294,1891,0,165641,161405.32999965976,1519561
OR,62586967.535441294,1892,0,176066,161405.32999965976,1695627
OR,62586967.535441294,1893,0,148788,161405.32999965976,1844415
OR,62586967.535441294,1894,0,116098,161405.32999965976,1960513
OR,62586967.535441294,1895,331.71000000000004,132405,161737.03999965976,2092918
OR,62586967.535441294,1896,0,152265,161737.03999965976,2245183
OR,62586967.535441294,1897,0,178002,161737.03999965976,2423185
OR,62586967.535441294,1898,0,211398,161737.03999965976,2634583
OR,62586967.535441294,1899,0,179811,161737.03999965976,2814394
OR,62586967.535441294,1900,0,168145,161737.03999965976,2982539
OR,62586967.535441294,1901,0,152190,161737.03999965976,3134729
OR,62586967.535441294,1902,160,130836,161897.03999965976,3265565
OR,62586967.535441294,1903,0,118437,161897.03999965976,3384002
OR,62586967.535441294,1904,0,109638,161897.03999965976,3493640
OR,62586967.535441294,1905,0,147504,161897.03999965976,3641144
OR,62586967.535441294,1906,0,140974,161897.03999965976,3782118
OR,62586967.535441294,1907,0,162777,161897.03999965976,3944895
OR,62586967.535441294,1908,0,299973,161897.03999965976,4244868
OR,62586967.535441294,1909,0,246426,161897.03999965976,4491294
OR,62586967.535441294,1910,0,250301,161897.03999965976,4741595
OR,62586967.535441294,1911,0,204439,161897.03999965976,4946034
OR,62586967.535441294,1912,0,193592,161897.03999965976,5139626
OR,62586967.535441294,1913,0,201554,161897.03999965976,5341180
OR,62586967.535441294,1914,0,261118,161897.03999965976,5602298
OR,62586967.535441294,1915,0,272905,161897.03999965976,5875203
OR,62586967.535441294,1916,0,329832,161897.03999965976,6205035
OR,62586967.535441294,1917,0,371627,161897.03999965976,6576662
OR,62586967.535441294,1918,0,419115,161897.03999965976,6995777
OR,62586967.535441294,1919,0,368701,161897.03999965976,7364478
OR,62586967.535441294,1920,0,348320,161897.03999965976,7712798
OR,62586967.535441294,1921,0,336725,161897.03999965976,8049523
OR,62586967.535441294,1922,0,347265,161897.03999965976,8396788
OR,62586967.535441294,1923,0,313984,161897.03999965976,8710772
OR,62586967.535441294,1924,0,341925,161897.03999965976,9052697
OR,62586967.535441294,1925,0,293125,161897.03999965976,9345822
OR,62586967.535441294,1926,0,236840,161897.03999965976,9582662
OR,62586967.535441294,1927,0,156830,161897.03999965976,9739492
OR,62586967.535441294,1928,0,74670,161897.03999965976,9814162
OR,62586967.535441294,1929,0,67874,161897.03999965976,9882036
OR,62586967.535441294,1930,0,76999,161897.03999965976,9959035
PA,29028848.8108735,1862,0,0,0,0
PA,29028848.8108735,1863,0,0,0,0
PA,29028848.8108735,1864,0,0,0,0
PA,29028848.8108735,1865,0,0,0,0
PA,29028848.8108735,1866,0,0,0,0
PA,29028848.8108735,1867,0,0,0,0
PA,29028848.8108735,1868,0,0,0,0
PA,29028848.8108735,1869,0,0,0,0
PA,29028848.8108735,1870,0,0,0,0
PA,29028848.8108735,1871,0,0,0,0
PA,29028848.8108735,1872,0,0,0,0
PA,29028848.8108735,1873,0,0,0,0
PA,29028848.8108735,1874,0,0,0,0
PA,29028848.8108735,1875,0,0,0,0
PA,29028848.8108735,1876,0,0,0,0
PA,29028848.8108735,1877,0,0,0,0
PA,29028848.8108735,1878,0,0,0,0
PA,29028848.8108735,1879,0,0,0,0
PA,29028848.8108735,1880,0,0,0,0
PA,29028848.8108735,1881,0,0,0,0
PA,29028848.8108735,1882,0,0,0,0
PA,29028848.8108735,1883,0,0,0,0
PA,29028848.8108735,1884,0,0,0,0
PA,29028848.8108735,1885,0,0,0,0
PA,29028848.8108735,1886,0,0,0,0
PA,29028848.8108735,1887,0,0,0,0
PA,29028848.8108735,1888,0,0,0,0
PA,29028848.8108735,1889,0,0,0,0
PA,29028848.8108735,1890,0,0,0,0
PA,29028848.8108735,1891,0,0,0,0
PA,29028848.8108735,1892,0,0,0,0
PA,29028848.8108735,1893,0,0,0,0
PA,29028848.8108735,1894,0,0,0,0
PA,29028848.8108735,1895,0,0,0,0
PA,29028848.8108735,1896,0,0,0,0
PA,29028848.8108735,1897,0,0,0,0
PA,29028848.8108735,1898,0,0,0,0
PA,29028848.8108735,1899,0,0,0,0
PA,29028848.8108735,1900,0,0,0,0
PA,29028848.8108735,1901,0,0,0,0
PA,29028848.8108735,1902,0,0,0,0
PA,29028848.8108735,1903,0,0,0,0
PA,29028848.8108735,1904,0,0,0,0
PA,29028848.8108735,1905,0,0,0,0
PA,29028848.8108735,1906,0,0,0,0
PA,29028848.8108735,1907,0,0,0,0
PA,29028848.8108735,1908,0,0,0,0
PA,29028848.8108735,1909,0,0,0,0
PA,29028848.8108735,1910,0,0,0,0
PA,29028848.8108735,1911,0,0,0,0
PA,29028848.8108735,1912,0,0,0,0
PA,29028848.8108735,1913,0,0,0,0
PA,29028848.8108735,1914,0,0,0,0
PA,29028848.8108735,1915,0,0,0,0
PA,29028848.8108735,1916,0,0,0,0
PA,29028848.8108735,1917,0,0,0,0
PA,29028848.8108735,1918,0,0,0,0
PA,29028848.8108735,1919,0,0,0,0
PA,29028848.8108735,1920,0,0,0,0
PA,29028848.8108735,1921,0,0,0,0
PA,29028848.8108735,1922,0,0,0,0
PA,29028848.8108735,1923,0,0,0,0
PA,29028848.8108735,1924,0,0,0,0
PA,29028848.8108735,1925,0,0,0,0
PA,29028848.8108735,1926,0,0,0,0
PA,29028848.8108735,1927,0,0,0,0
PA,29028848.8108735,1928,0,0,0,0
PA,29028848.8108735,1929,0,0,0,0
PA,29028848.8108735,1930,0,0,0,0
RI,704499.0598773925,1862,0,0,0,0
RI,704499.0598773925,1863,0,0,0,0
RI,704499.0598773925,1864,0,0,0,0
RI,704499.0598773925,1865,0,0,0,0
RI,704499.0598773925,1866,0,0,0,0
RI,704499.0598773925,1867,0,0,0,0
RI,704499.0598773925,1868,0,0,0,0
RI,704499.0598773925,1869,0,0,0,0
RI,704499.0598773925,1870,0,0,0,0
RI,704499.0598773925,1871,0,0,0,0
RI,704499.0598773925,1872,0,0,0,0
RI,704499.0598773925,1873,0,0,0,0
RI,704499.0598773925,1874,0,0,0,0
RI,704499.0598773925,1875,0,0,0,0
RI,704499.0598773925,1876,0,0,0,0
RI,704499.0598773925,1877,0,0,0,0
RI,704499.0598773925,1878,0,0,0,0
RI,704499.0598773925,1879,0,0,0,0
RI,704499.0598773925,1880,0,0,0,0
RI,704499.0598773925,1881,0,0,0,0
RI,704499.0598773925,1882,0,0,0,0
RI,704499.0598773925,1883,0,0,0,0
RI,704499.0598773925,1884,0,0,0,0
RI,704499.0598773925,1885,0,0,0,0
RI,704499.0598773925,1886,0,0,0,0
RI,704499.0598773925,1887,0,0,0,0
RI,704499.0598773925,1888,0,0,0,0
RI,704499.0598773925,1889,0,0,0,0
RI,704499.0598773925,1890,0,0,0,0
RI,704499.0598773925,1891,0,0,0,0
RI,704499.0598773925,1892,0,0,0,0
RI,704499.0598773925,1893,0,0,0,0
RI,704499.0598773925,1894,0,0,0,0
RI,704499.0598773925,1895,0,0,0,0
RI,704499.0598773925,1896,0,0,0,0
RI,704499.0598773925,1897,0,0,0,0
RI,704499.0598773925,1898,0,0,0,0
RI,704499.0598773925,1899,0,0,0,0
RI,704499.0598773925,1900,0,0,0,0
RI,704499.0598773925,1901,0,0,0,0
RI,704499.0598773925,1902,0,0,0,0
RI,704499.0598773925,1903,0,0,0,0
RI,704499.0598773925,1904,0,0,0,0
RI,704499.0598773925,1905,0,0,0,0
RI,704499.0598773925,1906,0,0,0,0
RI,704499.0598773925,1907,0,0,0,0
RI,704499.0598773925,1908,0,0,0,0
RI,704499.0598773925,1909,0,0,0,0
RI,704499.0598773925,1910,0,0,0,0
RI,704499.0598773925,1911,0,0,0,0
RI,704499.0598773925,1912,0,0,0,0
RI,704499.0598773925,1913,0,0,0,0
RI,704499.0598773925,1914,0,0,0,0
RI,704499.0598773925,1915,0,0,0,0
RI,704499.0598773925,1916,0,0,0,0
RI,704499.0598773925,1917,0,0,0,0
RI,704499.0598773925,1918,0,0,0,0
RI,704499.0598773925,1919,0,0,0,0
RI,704499.0598773925,1920,0,0,0,0
RI,704499.0598773925,1921,0,0,0,0
RI,704499.0598773925,1922,0,0,0,0
RI,704499.0598773925,1923,0,0,0,0
RI,704499.0598773925,1924,0,0,0,0
RI,704499.0598773925,1925,0,0,0,0
RI,704499.0598773925,1926,0,0,0,0
RI,704499.0598773925,1927,0,0,0,0
RI,704499.0598773925,1928,0,0,0,0
RI,704499.0598773925,1929,0,0,0,0
RI,704499.0598773925,1930,0,0,0,0
SC,20077239.999007806,1862,0,0,0,0
SC,20077239.999007806,1863,0,0,0,0
SC,20077239.999007806,1864,0,0,0,0
SC,20077239.999007806,1865,0,0,0,0
SC,20077239.999007806,1866,0,0,0,0
SC,20077239.999007806,1867,0,0,0,0
SC,20077239.999007806,1868,0,0,0,0
SC,20077239.999007806,1869,0,0,0,0
SC,20077239.999007806,1870,0,0,0,0
SC,20077239.999007806,1871,0,0,0,0
SC,20077239.999007806,1872,0,0,0,0
SC,20077239.999007806,1873,0,0,0,0
SC,20077239.999007806,1874,0,0,0,0
SC,20077239.999007806,1875,0,0,0,0
SC,20077239.999007806,1876,0,0,0,0
SC,20077239.999007806,1877,0,0,0,0
SC,20077239.999007806,1878,0,0,0,0
SC,20077239.999007806,1879,0,0,0,0
SC,20077239.999007806,1880,0,0,0,0
SC,20077239.999007806,1881,0,0,0,0
SC,20077239.999007806,1882,0,0,0,0
SC,20077239.999007806,1883,0,0,0,0
SC,20077239.999007806,1884,0,0,0,0
SC,20077239.999007806,1885,0,0,0,0
SC,20077239.999007806,1886,0,0,0,0
SC,20077239.999007806,1887,0,0,0,0
SC,20077239.999007806,1888,0,0,0,0
SC,20077239.999007806,1889,0,0,0,0
SC,20077239.999007806,1890,0,0,0,0
SC,20077239.999007806,1891,0,0,0,0
SC,20077239.999007806,1892,0,0,0,0
SC,20077239.999007806,1893,0,0,0,0
SC,20077239.999007806,1894,0,0,0,0
SC,20077239.999007806,1895,0,0,0,0
SC,20077239.999007806,1896,0,0,0,0
SC,20077239.999007806,1897,0,0,0,0
SC,20077239.999007806,1898,0,0,0,0
SC,20077239.999007806,1899,0,0,0,0
SC,20077239.999007806,1900,0,0,0,0
SC,20077239.999007806,1901,0,0,0,0
SC,20077239.999007806,1902,0,0,0,0
SC,20077239.999007806,1903,0,0,0,0
SC,20077239.999007806,1904,0,0,0,0
SC,20077239.999007806,1905,0,0,0,0
SC,20077239.999007806,1906,0,0,0,0
SC,20077239.999007806,1907,0,0,0,0
SC,20077239.999007806,1908,0,0,0,0
SC,20077239.999007806,1909,0,0,0,0
SC,20077239.999007806,1910,0,0,0,0
SC,20077239.999007806,1911,0,0,0,0
SC,20077239.999007806,1912,0,0,0,0
SC,20077239.999007806,1913,0,0,0,0
SC,20077239.999007806,1914,0,0,0,0
SC,20077239.999007806,1915,0,0,0,0
SC,20077239.999007806,1916,0,0,0,0
SC,20077239.999007806,1917,0,0,0,0
SC,20077239.999007806,1918,0,0,0,0
SC,20077239.999007806,1919,0,0,0,0
SC,20077239.999007806,1920,0,0,0,0
SC,20077239.999007806,1921,0,0,0,0
SC,20077239.999007806,1922,0,0,0,0
SC,20077239.999007806,1923,0,0,0,0
SC,20077239.999007806,1924,0,0,0,0
SC,20077239.999007806,1925,0,0,0,0
SC,20077239.999007806,1926,0,0,0,0
SC,20077239.999007806,1927,0,0,0,0
SC,20077239.999007806,1928,0,0,0,0
SC,20077239.999007806,1929,0,0,0,0
SC,20077239.999007806,1930,0,0,0,0
SD,49808066.40558712,1862,0,0,0,0
SD,49808066.40558712,1863,0,0,0,0
SD,49808066.40558712,1864,0,0,0,0
SD,49808066.40558712,1865,0,0,0,0
SD,49808066.40558712,1866,0,0,0,0
SD,49808066.40558712,1867,0,0,0,0
SD,49808066.40558712,1868,0,2301,0,2301
SD,49808066.40558712,1869,0,2196,0,4497
SD,49808066.40558712,1870,0,1600,0,6097
SD,49808066.40558712,1871,2479.5,2599.5,2479.5,8696.5
SD,49808066.40558712,1872,30427.083333330007,5724,32906.58333333001,14420.5
SD,49808066.40558712,1873,75113.74416665999,13604,108020.32749999,28024.5
SD,49808066.40558712,1874,64340.87666666,27163,172361.20416665002,55187.5
SD,49808066.40558712,1875,9571.61833335,31171,181932.8225,86358.5
SD,49808066.40558712,1876,4571.290000000002,45461.5,186504.11250000002,131820
SD,49808066.40558712,1877,1836.03,44002,188340.14250000002,175822
SD,49808066.40558712,1878,1989.4399999999998,61076.5,190329.58250000002,236898.5
SD,49808066.40558712,1879,1219.905,81499.5,191549.48750000002,318398
SD,49808066.40558712,1880,689.16,79825,192238.64750000002,398223
SD,49808066.40558712,1881,1227.13833333,67864.5,193465.78583333,466087.5
SD,49808066.40558712,1882,759.55166666,105043.5,194225.33749999,571131
SD,49808066.40558712,1883,1271.44,132421.5,195496.77749999,703552.5
SD,49808066.40558712,1884,160,198908.5,195656.77749999,902461
SD,49808066.40558712,1885,0,274015.5,195656.77749999,1176476.5
SD,49808066.40558712,1886,1394.3899999999999,244815.5,197051.16749999003,1421292
SD,49808066.40558712,1887,0,303502.5,197051.16749999003,1724794.5
SD,49808066.40558712,1888,639.62,438998,197690.78749999002,2163792.5
SD,49808066.40558712,1889,1384.1700000100002,458380,199074.95750000002,2622172.5
SD,49808066.40558712,1890,142.45,582729,199217.40750000003,3204901.5
SD,49808066.40558712,1891,106.61,376966,199324.01750000002,3581867.5
SD,49808066.40558712,1892,11233.69,246998,210557.70750000002,3828865.5
SD,49808066.40558712,1893,0,275713,210557.70750000002,4104578.5
SD,49808066.40558712,1894,34079.76999998999,188440,244637.47749999003,4293018.5
SD,49808066.40558712,1895,45901.82000000001,138966,290539.29749999003,4431984.5
SD,49808066.40558712,1896,24527.539999999997,137281,315066.83749999,4569265.5
SD,49808066.40558712,1897,20902.659999999996,107800,335969.49749999,4677065.5
SD,49808066.40558712,1898,1627.8600000000001,142399,337597.35749999,4819464.5
SD,49808066.40558712,1899,0,202782,337597.35749999,5022246.5
SD,49808066.40558712,1900,3584.5000000000005,210812,341181.85749999,5233058.5
SD,49808066.40558712,1901,4670.919999999999,402590,345852.77749998996,5635648.5
SD,49808066.40558712,1902,7243.95,305499,353096.72749998997,5941147.5
SD,49808066.40558712,1903,429.17,216957,353525.89749998995,6158104.5
SD,49808066.40558712,1904,0,161156,353525.89749998995,6319260.5
SD,49808066.40558712,1905,31.36,287722,353557.25749998994,6606982.5
SD,49808066.40558712,1906,120,317173,353677.25749998994,6924155.5
SD,49808066.40558712,1907,72.39,633269,353749.64749998995,7557424.5
SD,49808066.40558712,1908,70.77000000000001,934554,353820.41749998997,8491978.5
SD,49808066.40558712,1909,21,1145128,353841.41749998997,9637106.5
SD,49808066.40558712,1910,0,1035513,353841.41749998997,10672619.5
SD,49808066.40558712,1911,0,1316234,353841.41749998997,11988853.5
SD,49808066.40558712,1912,0,1279681,353841.41749998997,13268534.5
SD,49808066.40558712,1913,0,621124,353841.41749998997,13889658.5
SD,49808066.40558712,1914,80,527266,353921.41749998997,14416924.5
SD,49808066.40558712,1915,0,338153,353921.41749998997,14755077.5
SD,49808066.40558712,1916,0,207416,353921.41749998997,14962493.5
SD,49808066.40558712,1917,0,290093,353921.41749998997,15252586.5
SD,49808066.40558712,1918,0,226126,353921.41749998997,15478712.5
SD,49808066.40558712,1919,0,202959,353921.41749998997,15681671.5
SD,49808066.40558712,1920,0,442633,353921.41749998997,16124304.5
SD,49808066.40558712,1921,0,513576,353921.41749998997,16637880.5
SD,49808066.40558712,1922,160,436025,354081.41749998997,17073905.5
SD,49808066.40558712,1923,0,214069,354081.41749998997,17287974.5
SD,49808066.40558712,1924,0,266589,354081.41749998997,17554563.5
SD,49808066.40558712,1925,0,195206,354081.41749998997,17749769.5
SD,49808066.40558712,1926,0,163956,354081.41749998997,17913725.5
SD,49808066.40558712,1927,0,56155,354081.41749998997,17969880.5
SD,49808066.40558712,1928,0,59031,354081.41749998997,18028911.5
SD,49808066.40558712,1929,0,37381,354081.41749998997,18066292.5
SD,49808066.40558712,1930,0,25750,354081.41749998997,18092042.5
TN,27051404.218321744,1862,0,0,0,0
TN,27051404.218321744,1863,0,0,0,0
TN,27051404.218321744,1864,0,0,0,0
TN,27051404.218321744,1865,0,0,0,0
TN,27051404.218321744,1866,0,0,0,0
TN,27051404.218321744,1867,0,0,0,0
TN,27051404.218321744,1868,0,0,0,0
TN,27051404.218321744,1869,0,0,0,0
TN,27051404.218321744,1870,0,0,0,0
TN,27051404.218321744,1871,0,0,0,0
TN,27051404.218321744,1872,0,0,0,0
TN,27051404.218321744,1873,0,0,0,0
TN,27051404.218321744,1874,0,0,0,0
TN,27051404.218321744,1875,0,0,0,0
TN,27051404.218321744,1876,0,0,0,0
TN,27051404.218321744,1877,0,0,0,0
TN,27051404.218321744,1878,0,0,0,0
TN,27051404.218321744,1879,0,0,0,0
TN,27051404.218321744,1880,0,0,0,0
TN,27051404.218321744,1881,0,0,0,0
TN,27051404.218321744,1882,0,0,0,0
TN,27051404.218321744,1883,0,0,0,0
TN,27051404.218321744,1884,0,0,0,0
TN,27051404.218321744,1885,0,0,0,0
TN,27051404.218321744,1886,0,0,0,0
TN,27051404.218321744,1887,0,0,0,0
TN,27051404.218321744,1888,0,0,0,0
TN,27051404.218321744,1889,0,0,0,0
TN,27051404.218321744,1890,0,0,0,0
TN,27051404.218321744,1891,0,0,0,0
TN,27051404.218321744,1892,0,0,0,0
TN,27051404.218321744,1893,0,0,0,0
TN,27051404.218321744,1894,0,0,0,0
TN,27051404.218321744,1895,0,0,0,0
TN,27051404.218321744,1896,0,0,0,0
TN,27051404.218321744,1897,0,0,0,0
TN,27051404.218321744,1898,0,0,0,0
TN,27051404.218321744,1899,0,0,0,0
TN,27051404.218321744,1900,0,0,0,0
TN,27051404.218321744,1901,0,0,0,0
TN,27051404.218321744,1902,0,0,0,0
TN,27051404.218321744,1903,0,0,0,0
TN,27051404.218321744,1904,0,0,0,0
TN,27051404.218321744,1905,0,0,0,0
TN,27051404.218321744,1906,0,0,0,0
TN,27051404.218321744,1907,0,0,0,0
TN,27051404.218321744,1908,0,0,0,0
TN,27051404.218321744,1909,0,0,0,0
TN,27051404.218321744,1910,0,0,0,0
TN,27051404.218321744,1911,0,0,0,0
TN,27051404.218321744,1912,0,0,0,0
TN,27051404.218321744,1913,0,0,0,0
TN,27051404.218321744,1914,0,0,0,0
TN,27051404.218321744,1915,0,0,0,0
TN,27051404.218321744,1916,0,0,0,0
TN,27051404.218321744,1917,0,0,0,0
TN,27051404.218321744,1918,0,0,0,0
TN,27051404.218321744,1919,0,0,0,0
TN,27051404.218321744,1920,0,0,0,0
TN,27051404.218321744,1921,0,0,0,0
TN,27051404.218321744,1922,0,0,0,0
TN,27051404.218321744,1923,0,0,0,0
TN,27051404.218321744,1924,0,0,0,0
TN,27051404.218321744,1925,0,0,0,0
TN,27051404.218321744,1926,0,0,0,0
TN,27051404.218321744,1927,0,0,0,0
TN,27051404.218321744,1928,0,0,0,0
TN,27051404.218321744,1929,0,0,0,0
TN,27051404.218321744,1930,0,0,0,0
TX,173146834.99043107,1862,0,0,0,0
TX,173146834.99043107,1863,0,0,0,0
TX,173146834.99043107,1864,0,0,0,0
TX,173146834.99043107,1865,0,0,0,0
TX,173146834.99043107,1866,0,0,0,0
TX,173146834.99043107,1867,0,0,0,0
TX,173146834.99043107,1868,0,0,0,0
TX,173146834.99043107,1869,0,0,0,0
TX,173146834.99043107,1870,0,0,0,0
TX,173146834.99043107,1871,0,0,0,0
TX,173146834.99043107,1872,0,0,0,0
TX,173146834.99043107,1873,0,0,0,0
TX,173146834.99043107,1874,0,0,0,0
TX,173146834.99043107,1875,0,0,0,0
TX,173146834.99043107,1876,0,0,0,0
TX,173146834.99043107,1877,0,0,0,0
TX,173146834.99043107,1878,0,0,0,0
TX,173146834.99043107,1879,0,0,0,0
TX,173146834.99043107,1880,0,0,0,0
TX,173146834.99043107,1881,0,0,0,0
TX,173146834.99043107,1882,0,0,0,0
TX,173146834.99043107,1883,0,0,0,0
TX,173146834.99043107,1884,0,0,0,0
TX,173146834.99043107,1885,0,0,0,0
TX,173146834.99043107,1886,0,0,0,0
TX,173146834.99043107,1887,0,0,0,0
TX,173146834.99043107,1888,0,0,0,0
TX,173146834.99043107,1889,0,0,0,0
TX,173146834.99043107,1890,0,0,0,0
TX,173146834.99043107,1891,0,0,0,0
TX,173146834.99043107,1892,0,0,0,0
TX,173146834.99043107,1893,0,0,0,0
TX,173146834.99043107,1894,0,0,0,0
TX,173146834.99043107,1895,0,0,0,0
TX,173146834.99043107,1896,0,0,0,0
TX,173146834.99043107,1897,0,0,0,0
TX,173146834.99043107,1898,0,0,0,0
TX,173146834.99043107,1899,0,0,0,0
TX,173146834.99043107,1900,0,0,0,0
TX,173146834.99043107,1901,0,0,0,0
TX,173146834.99043107,1902,0,0,0,0
TX,173146834.99043107,1903,0,0,0,0
TX,173146834.99043107,1904,0,0,0,0
TX,173146834.99043107,1905,0,0,0,0
TX,173146834.99043107,1906,0,0,0,0
TX,173146834.99043107,1907,0,0,0,0
TX,173146834.99043107,1908,0,0,0,0
TX,173146834.99043107,1909,0,0,0,0
TX,173146834.99043107,1910,0,0,0,0
TX,173146834.99043107,1911,0,0,0,0
TX,173146834.99043107,1912,0,0,0,0
TX,173146834.99043107,1913,0,0,0,0
TX,173146834.99043107,1914,0,0,0,0
TX,173146834.99043107,1915,0,0,0,0
TX,173146834.99043107,1916,0,0,0,0
TX,173146834.99043107,1917,0,0,0,0
TX,173146834.99043107,1918,0,0,0,0
TX,173146834.99043107,1919,0,0,0,0
TX,173146834.99043107,1920,0,0,0,0
TX,173146834.99043107,1921,0,0,0,0
TX,173146834.99043107,1922,0,0,0,0
TX,173146834.99043107,1923,0,0,0,0
TX,173146834.99043107,1924,0,0,0,0
TX,173146834.99043107,1925,0,0,0,0
TX,173146834.99043107,1926,0,0,0,0
TX,173146834.99043107,1927,0,0,0,0
TX,173146834.99043107,1928,0,0,0,0
TX,173146834.99043107,1929,0,0,0,0
TX,173146834.99043107,1930,0,0,0,0
UT,54370523.9552325,1862,0,0,0,0
UT,54370523.9552325,1863,0,0,0,0
UT,54370523.9552325,1864,0,0,0,0
UT,54370523.9552325,1865,0,0,0,0
UT,54370523.9552325,1866,0,0,0,0
UT,54370523.9552325,1867,0,0,0,0
UT,54370523.9552325,1868,0,0,0,0
UT,54370523.9552325,1869,0,0,0,0
UT,54370523.9552325,1870,107.7,0,107.7,0
UT,54370523.9552325,1871,2007.90000001,0,2115.60000001,0
UT,54370523.9552325,1872,26075.22000001999,0,28190.820000029988,0
UT,54370523.9552325,1873,29160.559999989986,0,57351.38000001997,0
UT,54370523.9552325,1874,20774.004999990004,30176,78125.38500000998,30176
UT,54370523.9552325,1875,10213.519999999999,26907,88338.90500000998,57083
UT,54370523.9552325,1876,1543.0200000000002,23166,89881.92500000999,80249
UT,54370523.9552325,1877,640,29201,90521.92500000999,109450
UT,54370523.9552325,1878,0,31538,90521.92500000999,140988
UT,54370523.9552325,1879,320,12747,90841.92500000999,153735
UT,54370523.9552325,1880,160,19763,91001.92500000999,173498
UT,54370523.9552325,1881,320,37927,91321.92500000999,211425
UT,54370523.9552325,1882,159.41,59641,91481.33500000999,271066
UT,54370523.9552325,1883,0,61916,91481.33500000999,332982
UT,54370523.9552325,1884,0,57222,91481.33500000999,390204
UT,54370523.9552325,1885,0,48234,91481.33500000999,438438
UT,54370523.9552325,1886,480.4,37742,91961.73500000998,476180
UT,54370523.9552325,1887,0,31569,91961.73500000998,507749
UT,54370523.9552325,1888,5407.29,24741,97369.02500000998,532490
UT,54370523.9552325,1889,0,28153,97369.02500000998,560643
UT,54370523.9552325,1890,80,35233,97449.02500000998,595876
UT,54370523.9552325,1891,0,37750,97449.02500000998,633626
UT,54370523.9552325,1892,0,26740,97449.02500000998,660366
UT,54370523.9552325,1893,0,25796,97449.02500000998,686162
UT,54370523.9552325,1894,0,23138,97449.02500000998,709300
UT,54370523.9552325,1895,0,29855,97449.02500000998,739155
UT,54370523.9552325,1896,0,30035,97449.02500000998,769190
UT,54370523.9552325,1897,0,35403,97449.02500000998,804593
UT,54370523.9552325,1898,10855.24,50605,108304.26500000998,855198
UT,54370523.9552325,1899,0,51587,108304.26500000998,906785
UT,54370523.9552325,1900,45466.66999999999,48278,153770.93500000998,955063
UT,54370523.9552325,1901,54265.489999999976,47955,208036.42500000994,1003018
UT,54370523.9552325,1902,3319.73,36221,211356.15500000995,1039239
UT,54370523.9552325,1903,5298.9400000000005,37126,216655.09500000995,1076365
UT,54370523.9552325,1904,18198.449999999997,21541,234853.54500000994,1097906
UT,54370523.9552325,1905,0,16021,234853.54500000994,1113927
UT,54370523.9552325,1906,0,12256,234853.54500000994,1126183
UT,54370523.9552325,1907,11521.27,6451,246374.81500000993,1132634
UT,54370523.9552325,1908,10765.590000000002,12153,257140.40500000992,1144787
UT,54370523.9552325,1909,15521.609999999999,5875,272662.0150000099,1150662
UT,54370523.9552325,1910,120,5520,272782.0150000099,1156182
UT,54370523.9552325,1911,520,6529,273302.0150000099,1162711
UT,54370523.9552325,1912,5027.28,10332,278329.29500000994,1173043
UT,54370523.9552325,1913,0,29231,278329.29500000994,1202274
UT,54370523.9552325,1914,0,32135,278329.29500000994,1234409
UT,54370523.9552325,1915,3455.85,69638,281785.1450000099,1304047
UT,54370523.9552325,1916,0,119144,281785.1450000099,1423191
UT,54370523.9552325,1917,0,156080,281785.1450000099,1579271
UT,54370523.9552325,1918,37.73,124862,281822.8750000099,1704133
UT,54370523.9552325,1919,0,124993,281822.8750000099,1829126
UT,54370523.9552325,1920,0,143289,281822.8750000099,1972415
UT,54370523.9552325,1921,0,108024,281822.8750000099,2080439
UT,54370523.9552325,1922,0,98290,281822.8750000099,2178729
UT,54370523.9552325,1923,0,95117,281822.8750000099,2273846
UT,54370523.9552325,1924,0,98323,281822.8750000099,2372169
UT,54370523.9552325,1925,0,90183,281822.8750000099,2462352
UT,54370523.9552325,1926,40,134713,281862.8750000099,2597065
UT,54370523.9552325,1927,0,98579,281862.8750000099,2695644
UT,54370523.9552325,1928,0,66833,281862.8750000099,2762477
UT,54370523.9552325,1929,40,77873,281902.8750000099,2840350
UT,54370523.9552325,1930,80.3,85170,281983.1750000099,2925520
VA,25931926.760831572,1862,0,0,0,0
VA,25931926.760831572,1863,0,0,0,0
VA,25931926.760831572,1864,0,0,0,0
VA,25931926.760831572,1865,0,0,0,0
VA,25931926.760831572,1866,0,0,0,0
VA,25931926.760831572,1867,0,0,0,0
VA,25931926.760831572,1868,0,0,0,0
VA,25931926.760831572,1869,0,0,0,0
VA,25931926.760831572,1870,0,0,0,0
VA,25931926.760831572,1871,0,0,0,0
VA,25931926.760831572,1872,0,0,0,0
VA,25931926.760831572,1873,0,0,0,0
VA,25931926.760831572,1874,0,0,0,0
VA,25931926.760831572,1875,0,0,0,0
VA,25931926.760831572,1876,0,0,0,0
VA,25931926.760831572,1877,0,0,0,0
VA,25931926.760831572,1878,0,0,0,0
VA,25931926.760831572,1879,0,0,0,0
VA,25931926.760831572,1880,0,0,0,0
VA,25931926.760831572,1881,0,0,0,0
VA,25931926.760831572,1882,0,0,0,0
VA,25931926.760831572,1883,0,0,0,0
VA,25931926.760831572,1884,0,0,0,0
VA,25931926.760831572,1885,0,0,0,0
VA,25931926.760831572,1886,0,0,0,0
VA,25931926.760831572,1887,0,0,0,0
VA,25931926.760831572,1888,0,0,0,0
VA,25931926.760831572,1889,0,0,0,0
VA,25931926.760831572,1890,0,0,0,0
VA,25931926.760831572,1891,0,0,0,0
VA,25931926.760831572,1892,0,0,0,0
VA,25931926.760831572,1893,0,0,0,0
VA,25931926.760831572,1894,0,0,0,0
VA,25931926.760831572,1895,0,0,0,0
VA,25931926.760831572,1896,0,0,0,0
VA,25931926.760831572,1897,0,0,0,0
VA,25931926.760831572,1898,0,0,0,0
VA,25931926.760831572,1899,0,0,0,0
VA,25931926.760831572,1900,0,0,0,0
VA,25931926.760831572,1901,0,0,0,0
VA,25931926.760831572,1902,0,0,0,0
VA,25931926.760831572,1903,0,0,0,0
VA,25931926.760831572,1904,0,0,0,0
VA,25931926.760831572,1905,0,0,0,0
VA,25931926.760831572,1906,0,0,0,0
VA,25931926.760831572,1907,0,0,0,0
VA,25931926.760831572,1908,0,0,0,0
VA,25931926.760831572,1909,0,0,0,0
VA,25931926.760831572,1910,0,0,0,0
VA,25931926.760831572,1911,0,0,0,0
VA,25931926.760831572,1912,0,0,0,0
VA,25931926.760831572,1913,0,0,0,0
VA,25931926.760831572,1914,0,0,0,0
VA,25931926.760831572,1915,0,0,0,0
VA,25931926.760831572,1916,0,0,0,0
VA,25931926.760831572,1917,0,0,0,0
VA,25931926.760831572,1918,0,0,0,0
VA,25931926.760831572,1919,0,0,0,0
VA,25931926.760831572,1920,0,0,0,0
VA,25931926.760831572,1921,0,0,0,0
VA,25931926.760831572,1922,0,0,0,0
VA,25931926.760831572,1923,0,0,0,0
VA,25931926.760831572,1924,0,0,0,0
VA,25931926.760831572,1925,0,0,0,0
VA,25931926.760831572,1926,0,0,0,0
VA,25931926.760831572,1927,0,0,0,0
VA,25931926.760831572,1928,0,0,0,0
VA,25931926.760831572,1929,0,0,0,0
VA,25931926.760831572,1930,0,0,0,0
VT,6202364.077591833,1862,0,0,0,0
VT,6202364.077591833,1863,0,0,0,0
VT,6202364.077591833,1864,0,0,0,0
VT,6202364.077591833,1865,0,0,0,0
VT,6202364.077591833,1866,0,0,0,0
VT,6202364.077591833,1867,0,0,0,0
VT,6202364.077591833,1868,0,0,0,0
VT,6202364.077591833,1869,0,0,0,0
VT,6202364.077591833,1870,0,0,0,0
VT,6202364.077591833,1871,0,0,0,0
VT,6202364.077591833,1872,0,0,0,0
VT,6202364.077591833,1873,0,0,0,0
VT,6202364.077591833,1874,0,0,0,0
VT,6202364.077591833,1875,0,0,0,0
VT,6202364.077591833,1876,0,0,0,0
VT,6202364.077591833,1877,0,0,0,0
VT,6202364.077591833,1878,0,0,0,0
VT,6202364.077591833,1879,0,0,0,0
VT,6202364.077591833,1880,0,0,0,0
VT,6202364.077591833,1881,0,0,0,0
VT,6202364.077591833,1882,0,0,0,0
VT,6202364.077591833,1883,0,0,0,0
VT,6202364.077591833,1884,0,0,0,0
VT,6202364.077591833,1885,0,0,0,0
VT,6202364.077591833,1886,0,0,0,0
VT,6202364.077591833,1887,0,0,0,0
VT,6202364.077591833,1888,0,0,0,0
VT,6202364.077591833,1889,0,0,0,0
VT,6202364.077591833,1890,0,0,0,0
VT,6202364.077591833,1891,0,0,0,0
VT,6202364.077591833,1892,0,0,0,0
VT,6202364.077591833,1893,0,0,0,0
VT,6202364.077591833,1894,0,0,0,0
VT,6202364.077591833,1895,0,0,0,0
VT,6202364.077591833,1896,0,0,0,0
VT,6202364.077591833,1897,0,0,0,0
VT,6202364.077591833,1898,0,0,0,0
VT,6202364.077591833,1899,0,0,0,0
VT,6202364.077591833,1900,0,0,0,0
VT,6202364.077591833,1901,0,0,0,0
VT,6202364.077591833,1902,0,0,0,0
VT,6202364.077591833,1903,0,0,0,0
VT,6202364.077591833,1904,0,0,0,0
VT,6202364.077591833,1905,0,0,0,0
VT,6202364.077591833,1906,0,0,0,0
VT,6202364.077591833,1907,0,0,0,0
VT,6202364.077591833,1908,0,0,0,0
VT,6202364.077591833,1909,0,0,0,0
VT,6202364.077591833,1910,0,0,0,0
VT,6202364.077591833,1911,0,0,0,0
VT,6202364.077591833,1912,0,0,0,0
VT,6202364.077591833,1913,0,0,0,0
VT,6202364.077591833,1914,0,0,0,0
VT,6202364.077591833,1915,0,0,0,0
VT,6202364.077591833,1916,0,0,0,0
VT,6202364.077591833,1917,0,0,0,0
VT,6202364.077591833,1918,0,0,0,0
VT,6202364.077591833,1919,0,0,0,0
VT,6202364.077591833,1920,0,0,0,0
VT,6202364.077591833,1921,0,0,0,0
VT,6202364.077591833,1922,0,0,0,0
VT,6202364.077591833,1923,0,0,0,0
VT,6202364.077591833,1924,0,0,0,0
VT,6202364.077591833,1925,0,0,0,0
VT,6202364.077591833,1926,0,0,0,0
VT,6202364.077591833,1927,0,0,0,0
VT,6202364.077591833,1928,0,0,0,0
VT,6202364.077591833,1929,0,0,0,0
VT,6202364.077591833,1930,0,0,0,0
WA,44318409.88181194,1862,0,0,0,0
WA,44318409.88181194,1863,0,0,0,0
WA,44318409.88181194,1864,0,0,0,0
WA,44318409.88181194,1865,0,0,0,0
WA,44318409.88181194,1866,1280,0,1280,0
WA,44318409.88181194,1867,0,0,1280,0
WA,44318409.88181194,1868,0,9270,1280,9270
WA,44318409.88181194,1869,4316.73,35127,5596.73,44397
WA,44318409.88181194,1870,3200.5200000000004,20961,8797.25,65358
WA,44318409.88181194,1871,0,15896,8797.25,81254
WA,44318409.88181194,1872,36074.060000009995,14098,44871.310000009995,95352
WA,44318409.88181194,1873,7524.740000000002,15969,52396.05000001,111321
WA,44318409.88181194,1874,6171.189999990001,14163,58567.24,125484
WA,44318409.88181194,1875,1863.4149999999997,27875,60430.655,153359
WA,44318409.88181194,1876,485.51500001,38840,60916.170000009995,192199
WA,44318409.88181194,1877,1170.91000001,36821,62087.080000019996,229020
WA,44318409.88181194,1878,43.55,37141,62130.63000002,266161
WA,44318409.88181194,1879,0,38562,62130.63000002,304723
WA,44318409.88181194,1880,0,35796,62130.63000002,340519
WA,44318409.88181194,1881,0,43083,62130.63000002,383602
WA,44318409.88181194,1882,160,52648,62290.63000002,436250
WA,44318409.88181194,1883,0,88507,62290.63000002,524757
WA,44318409.88181194,1884,0,105471,62290.63000002,630228
WA,44318409.88181194,1885,0,110981,62290.63000002,741209
WA,44318409.88181194,1886,0,108671,62290.63000002,849880
WA,44318409.88181194,1887,0,127177,62290.63000002,977057
WA,44318409.88181194,1888,0,134976,62290.63000002,1112033
WA,44318409.88181194,1889,160,178684,62450.63000002,1290717
WA,44318409.88181194,1890,963.31,314601,63413.94000002,1605318
WA,44318409.88181194,1891,0,185704,63413.94000002,1791022
WA,44318409.88181194,1892,0,166005,63413.94000002,1957027
WA,44318409.88181194,1893,10196.720000000001,157873,73610.66000002,2114900
WA,44318409.88181194,1894,13883.680000000002,141880,87494.34000002,2256780
WA,44318409.88181194,1895,30094.920000000006,174962,117589.26000002,2431742
WA,44318409.88181194,1896,5600,222638,123189.26000002,2654380
WA,44318409.88181194,1897,793.575,256076,123982.83500002,2910456
WA,44318409.88181194,1898,40,279586,124022.83500002,3190042
WA,44318409.88181194,1899,2040,231276,126062.83500002,3421318
WA,44318409.88181194,1900,2220.7200000000003,228123,128283.55500002,3649441
WA,44318409.88181194,1901,1760.25,148592,130043.80500002,3798033
WA,44318409.88181194,1902,5869.2,146139,135913.00500002,3944172
WA,44318409.88181194,1903,0,133627,135913.00500002,4077799
WA,44318409.88181194,1904,80,115474,135993.00500002,4193273
WA,44318409.88181194,1905,200,255507,136193.00500002,4448780
WA,44318409.88181194,1906,2787.99,355567,138980.99500002,4804347
WA,44318409.88181194,1907,200,447215,139180.99500002,5251562
WA,44318409.88181194,1908,376.03499999999997,487803,139557.03000002,5739365
WA,44318409.88181194,1909,358.38,313307,139915.41000002,6052672
WA,44318409.88181194,1910,0,354318,139915.41000002,6406990
WA,44318409.88181194,1911,83.12,309291,139998.53000002,6716281
WA,44318409.88181194,1912,0,205591,139998.53000002,6921872
WA,44318409.88181194,1913,160,175768,140158.53000002,7097640
WA,44318409.88181194,1914,78.57,205862,140237.10000002,7303502
WA,44318409.88181194,1915,0,151742,140237.10000002,7455244
WA,44318409.88181194,1916,38.1,125104,140275.20000002,7580348
WA,44318409.88181194,1917,37.55,128193,140312.75000002,7708541
WA,44318409.88181194,1918,0,124089,140312.75000002,7832630
WA,44318409.88181194,1919,75.03,105601,140387.78000002,7938231
WA,44318409.88181194,1920,0,99283,140387.78000002,8037514
WA,44318409.88181194,1921,224.48999999999998,83185,140612.27000001998,8120699
WA,44318409.88181194,1922,0,76038,140612.27000001998,8196737
WA,44318409.88181194,1923,37.26,50008,140649.53000002,8246745
WA,44318409.88181194,1924,72.53999999999999,45326,140722.07000002,8292071
WA,44318409.88181194,1925,293.73,37372,141015.80000002,8329443
WA,44318409.88181194,1926,0,29018,141015.80000002,8358461
WA,44318409.88181194,1927,39.79,20005,141055.59000002002,8378466
WA,44318409.88181194,1928,0,11469,141055.59000002002,8389935
WA,44318409.88181194,1929,0,11084,141055.59000002002,8401019
WA,44318409.88181194,1930,40,6198,141095.59000002002,8407217
WI,36275408.33045983,1862,0,0,0,0
WI,36275408.33045983,1863,0,0,0,0
WI,36275408.33045983,1864,0,0,0,0
WI,36275408.33045983,1865,5318.655,0,5318.655,0
WI,36275408.33045983,1866,279570.6483333198,0,284889.30333331984,0
WI,36275408.33045983,1867,295626.59666663996,0,580515.8999999599,0
WI,36275408.33045983,1868,316528.6850000099,52211,897044.5849999697,52211
WI,36275408.33045983,1869,212426.92500001003,58758,1109471.5099999798,110969
WI,36275408.33045983,1870,161905.41000000003,62074,1271376.91999998,173043
WI,36275408.33045983,1871,34150.299999999996,59724,1305527.21999998,232767
WI,36275408.33045983,1872,5868.51000001,69830,1311395.72999999,302597
WI,36275408.33045983,1873,8444.009999990001,85918,1319839.73999998,388515
WI,36275408.33045983,1874,6967.727499990001,130226,1326807.46749997,518741
WI,36275408.33045983,1875,1202.6425,137695,1328010.10999997,656436
WI,36275408.33045983,1876,600,132235,1328610.10999997,788671
WI,36275408.33045983,1877,934.3,112913,1329544.40999997,901584
WI,36275408.33045983,1878,320,108943,1329864.40999997,1010527
WI,36275408.33045983,1879,0,83813,1329864.40999997,1094340
WI,36275408.33045983,1880,3360,86485,1333224.40999997,1180825
WI,36275408.33045983,1881,640,92298,1333864.40999997,1273123
WI,36275408.33045983,1882,361.1,78681,1334225.5099999702,1351804
WI,36275408.33045983,1883,320,72902,1334545.5099999702,1424706
WI,36275408.33045983,1884,80,96939,1334625.5099999702,1521645
WI,36275408.33045983,1885,520,77986,1335145.5099999702,1599631
WI,36275408.33045983,1886,0,61466,1335145.5099999702,1661097
WI,36275408.33045983,1887,80,55114,1335225.5099999702,1716211
WI,36275408.33045983,1888,800.08,55276,1336025.5899999703,1771487
WI,36275408.33045983,1889,80,76801,1336105.5899999703,1848288
WI,36275408.33045983,1890,0,77471,1336105.5899999703,1925759
WI,36275408.33045983,1891,0,75021,1336105.5899999703,2000780
WI,36275408.33045983,1892,0,62538,1336105.5899999703,2063318
WI,36275408.33045983,1893,0,53833,1336105.5899999703,2117151
WI,36275408.33045983,1894,0,42068,1336105.5899999703,2159219
WI,36275408.33045983,1895,0,37185,1336105.5899999703,2196404
WI,36275408.33045983,1896,120,41595,1336225.5899999703,2237999
WI,36275408.33045983,1897,0,38883,1336225.5899999703,2276882
WI,36275408.33045983,1898,0,35599,1336225.5899999703,2312481
WI,36275408.33045983,1899,473.15499999,43262,1336698.7449999603,2355743
WI,36275408.33045983,1900,40.555,53510,1336739.2999999602,2409253
WI,36275408.33045983,1901,0,50065,1336739.2999999602,2459318
WI,36275408.33045983,1902,160,63290,1336899.2999999602,2522608
WI,36275408.33045983,1903,0,65362,1336899.2999999602,2587970
WI,36275408.33045983,1904,97.45,53780,1336996.7499999602,2641750
WI,36275408.33045983,1905,80,57454,1337076.7499999602,2699204
WI,36275408.33045983,1906,678.9199999999998,51425,1337755.66999996,2750629
WI,36275408.33045983,1907,160,58855,1337915.66999996,2809484
WI,36275408.33045983,1908,139.63,61364,1338055.29999996,2870848
WI,36275408.33045983,1909,0,51075,1338055.29999996,2921923
WI,36275408.33045983,1910,0,41373,1338055.29999996,2963296
WI,36275408.33045983,1911,0,34164,1338055.29999996,2997460
WI,36275408.33045983,1912,0,23221,1338055.29999996,3020681
WI,36275408.33045983,1913,0,21400,1338055.29999996,3042081
WI,36275408.33045983,1914,0,12238,1338055.29999996,3054319
WI,36275408.33045983,1915,0,13316,1338055.29999996,3067635
WI,36275408.33045983,1916,0,11145,1338055.29999996,3078780
WI,36275408.33045983,1917,0,9588,1338055.29999996,3088368
WI,36275408.33045983,1918,0,7066,1338055.29999996,3095434
WI,36275408.33045983,1919,0,3855,1338055.29999996,3099289
WI,36275408.33045983,1920,0,3554,1338055.29999996,3102843
WI,36275408.33045983,1921,0,2690,1338055.29999996,3105533
WI,36275408.33045983,1922,0,940,1338055.29999996,3106473
WI,36275408.33045983,1923,0,1376,1338055.29999996,3107849
WI,36275408.33045983,1924,0,1700,1338055.29999996,3109549
WI,36275408.33045983,1925,0,1006,1338055.29999996,3110555
WI,36275408.33045983,1926,0,0,1338055.29999996,3110555
WI,36275408.33045983,1927,0,0,1338055.29999996,3110555
WI,36275408.33045983,1928,0,0,1338055.29999996,3110555
WI,36275408.33045983,1929,0,0,1338055.29999996,3110555
WI,36275408.33045983,1930,0,0,1338055.29999996,3110555
WV,15511286.800314434,1862,0,0,0,0
WV,15511286.800314434,1863,0,0,0,0
WV,15511286.800314434,1864,0,0,0,0
WV,15511286.800314434,1865,0,0,0,0
WV,15511286.800314434,1866,0,0,0,0
WV,15511286.800314434,1867,0,0,0,0
WV,15511286.800314434,1868,0,0,0,0
WV,15511286.800314434,1869,0,0,0,0
WV,15511286.800314434,1870,0,0,0,0
WV,15511286.800314434,1871,0,0,0,0
WV,15511286.800314434,1872,0,0,0,0
WV,15511286.800314434,1873,0,0,0,0
WV,15511286.800314434,1874,0,0,0,0
WV,15511286.800314434,1875,0,0,0,0
WV,15511286.800314434,1876,0,0,0,0
WV,15511286.800314434,1877,0,0,0,0
WV,15511286.800314434,1878,0,0,0,0
WV,15511286.800314434,1879,0,0,0,0
WV,15511286.800314434,1880,0,0,0,0
WV,15511286.800314434,1881,0,0,0,0
WV,15511286.800314434,1882,0,0,0,0
WV,15511286.800314434,1883,0,0,0,0
WV,15511286.800314434,1884,0,0,0,0
WV,15511286.800314434,1885,0,0,0,0
WV,15511286.800314434,1886,0,0,0,0
WV,15511286.800314434,1887,0,0,0,0
WV,15511286.800314434,1888,0,0,0,0
WV,15511286.800314434,1889,0,0,0,0
WV,15511286.800314434,1890,0,0,0,0
WV,15511286.800314434,1891,0,0,0,0
WV,15511286.800314434,1892,0,0,0,0
WV,15511286.800314434,1893,0,0,0,0
WV,15511286.800314434,1894,0,0,0,0
WV,15511286.800314434,1895,0,0,0,0
WV,15511286.800314434,1896,0,0,0,0
WV,15511286.800314434,1897,0,0,0,0
WV,15511286.800314434,1898,0,0,0,0
WV,15511286.800314434,1899,0,0,0,0
WV,15511286.800314434,1900,0,0,0,0
WV,15511286.800314434,1901,0,0,0,0
WV,15511286.800314434,1902,0,0,0,0
WV,15511286.800314434,1903,0,0,0,0
WV,15511286.800314434,1904,0,0,0,0
WV,15511286.800314434,1905,0,0,0,0
WV,15511286.800314434,1906,0,0,0,0
WV,15511286.800314434,1907,0,0,0,0
WV,15511286.800314434,1908,0,0,0,0
WV,15511286.800314434,1909,0,0,0,0
WV,15511286.800314434,1910,0,0,0,0
WV,15511286.800314434,1911,0,0,0,0
WV,15511286.800314434,1912,0,0,0,0
WV,15511286.800314434,1913,0,0,0,0
WV,15511286.800314434,1914,0,0,0,0
WV,15511286.800314434,1915,0,0,0,0
WV,15511286.800314434,1916,0,0,0,0
WV,15511286.800314434,1917,0,0,0,0
WV,15511286.800314434,1918,0,0,0,0
WV,15511286.800314434,1919,0,0,0,0
WV,15511286.800314434,1920,0,0,0,0
WV,15511286.800314434,1921,0,0,0,0
WV,15511286.800314434,1922,0,0,0,0
WV,15511286.800314434,1923,0,0,0,0
WV,15511286.800314434,1924,0,0,0,0
WV,15511286.800314434,1925,0,0,0,0
WV,15511286.800314434,1926,0,0,0,0
WV,15511286.800314434,1927,0,0,0,0
WV,15511286.800314434,1928,0,0,0,0
WV,15511286.800314434,1929,0,0,0,0
WV,15511286.800314434,1930,0,0,0,0
WY,62921138.38063217,1862,0,0,0,0
WY,62921138.38063217,1863,0,0,0,0
WY,62921138.38063217,1864,0,0,0,0
WY,62921138.38063217,1865,0,0,0,0
WY,62921138.38063217,1866,0,0,0,0
WY,62921138.38063217,1867,0,0,0,0
WY,62921138.38063217,1868,0,0,0,0
WY,62921138.38063217,1869,0,0,0,0
WY,62921138.38063217,1870,0,0,0,0
WY,62921138.38063217,1871,0,0,0,0
WY,62921138.38063217,1872,1757.5199999999998,0,1757.5199999999998,0
WY,62921138.38063217,1873,957.24,0,2714.7599999999998,0
WY,62921138.38063217,1874,158.77,0,2873.5299999999997,0
WY,62921138.38063217,1875,0,480,2873.5299999999997,480
WY,62921138.38063217,1876,0,1480,2873.5299999999997,1960
WY,62921138.38063217,1877,0,880,2873.5299999999997,2840
WY,62921138.38063217,1878,0,960,2873.5299999999997,3800
WY,62921138.38063217,1879,0,753,2873.5299999999997,4553
WY,62921138.38063217,1880,0,2078,2873.5299999999997,6631
WY,62921138.38063217,1881,0,1573,2873.5299999999997,8204
WY,62921138.38063217,1882,0,3317,2873.5299999999997,11521
WY,62921138.38063217,1883,0,4975,2873.5299999999997,16496
WY,62921138.38063217,1884,0,7530,2873.5299999999997,24026
WY,62921138.38063217,1885,0,8882,2873.5299999999997,32908
WY,62921138.38063217,1886,0,8538,2873.5299999999997,41446
WY,62921138.38063217,1887,0,10252,2873.5299999999997,51698
WY,62921138.38063217,1888,0,12254,2873.5299999999997,63952
WY,62921138.38063217,1889,2736.73,19931,5610.26,83883
WY,62921138.38063217,1890,160,22105,5770.26,105988
WY,62921138.38063217,1891,160,36061,5930.26,142049
WY,62921138.38063217,1892,0,31508,5930.26,173557
WY,62921138.38063217,1893,0,46233,5930.26,219790
WY,62921138.38063217,1894,0,36449,5930.26,256239
WY,62921138.38063217,1895,20.12,34372,5950.38,290611
WY,62921138.38063217,1896,0,39907,5950.38,330518
WY,62921138.38063217,1897,6013.4,40086,11963.779999999999,370604
WY,62921138.38063217,1898,26845.350000000002,52799,38809.130000000005,423403
WY,62921138.38063217,1899,8163.12,54413,46972.25000000001,477816
WY,62921138.38063217,1900,17751.780000000002,59361,64724.03000000001,537177
WY,62921138.38063217,1901,3670.63,70963,68394.66000000002,608140
WY,62921138.38063217,1902,3512.48,81557,71907.14000000001,689697
WY,62921138.38063217,1903,80,62917,71987.14000000001,752614
WY,62921138.38063217,1904,0,73406,71987.14000000001,826020
WY,62921138.38063217,1905,0,101099,71987.14000000001,927119
WY,62921138.38063217,1906,0,114851,71987.14000000001,1041970
WY,62921138.38063217,1907,1303.93,123385,73291.07,1165355
WY,62921138.38063217,1908,2280.25,128189,75571.32,1293544
WY,62921138.38063217,1909,80,148638,75651.32,1442182
WY,62921138.38063217,1910,1361.35,122227,77012.67000000001,1564409
WY,62921138.38063217,1911,0,119951,77012.67000000001,1684360
WY,62921138.38063217,1912,833.63,113246,77846.30000000002,1797606
WY,62921138.38063217,1913,510.95000000000005,396856,78357.25000000001,2194462
WY,62921138.38063217,1914,3752.3,394070,82109.55000000002,2588532
WY,62921138.38063217,1915,1840.31,337541,83949.86000000002,2926073
WY,62921138.38063217,1916,2153.22,357005,86103.08000000002,3283078
WY,62921138.38063217,1917,115.07000000000001,422226,86218.15000000002,3705304
WY,62921138.38063217,1918,160,495986,86378.15000000002,4201290
WY,62921138.38063217,1919,0,434316,86378.15000000002,4635606
WY,62921138.38063217,1920,787.1800000000001,970358,87165.33000000002,5605964
WY,62921138.38063217,1921,282.15999999999997,1428660,87447.49000000002,7034624
WY,62921138.38063217,1922,560,1704944,88007.49000000002,8739568
WY,62921138.38063217,1923,80,1468525,88087.49000000002,10208093
WY,62921138.38063217,1924,1361.17,1202096,89448.66000000002,11410189
WY,62921138.38063217,1925,0,1025717,89448.66000000002,12435906
WY,62921138.38063217,1926,0,734235,89448.66000000002,13170141
WY,62921138.38063217,1927,160,461612,89608.66000000002,13631753
WY,62921138.38063217,1928,800.64,452165,90409.30000000002,14083918
WY,62921138.38063217,1929,320,356421,90729.30000000002,14440339
WY,62921138.38063217,1930,0,287161,90729.30000000002,14727500
